Node	Total SNPs	Num of SNPs inside recombinations	Num of SNPs outside recombinations	Num of Recombination Blocks	Bases in Recombinations	r/m	rho/theta	Genome Length	Bases in Clonal Frame
14913_2#10	30	0	30	0	0	0.000000	0.000000	2085607	2085607
17150_4#21	0	0	0	0	67421	0.000000	0.000000	2086603	2019168
13415_8#36	28	0	28	0	969	0.000000	0.000000	2088757	2087786
15995_1#43	24	0	24	0	969	0.000000	0.000000	2087759	2086788
14723_6#9	42	0	42	0	0	0.000000	0.000000	2091493	2091493
14410_8#43	259	229	30	4	55032	7.633333	0.133333	2081752	2080781
15731_8#49	0	0	0	0	197148	0.000000	0.000000	2082377	1885700
14412_1#59	0	0	0	0	41396	0.000000	0.000000	2088496	2047416
17138_4#51	8	0	8	0	30266	0.000000	0.000000	2103691	2073421
13415_7#58	448	406	42	8	55654	9.666667	0.190476	2062686	2062686
17175_6#11	37	13	24	2	6274	0.541667	0.083333	2094511	2093540
14913_2#70	135	105	30	2	19561	3.500000	0.066667	2080112	2079141
14913_4#93	67	30	37	2	7650	0.810811	0.054054	2086544	2086544
13415_4#90	141	122	19	5	93287	6.421052	0.263158	2077751	1989787
14412_1#8	41	9	32	1	4778	0.281250	0.031250	2091713	2091713
14723_3#92	243	203	40	1	51621	5.075000	0.025000	2087438	2069618
17175_4#47	0	0	0	0	67421	0.000000	0.000000	2085734	2018299
15995_1#44	195	182	13	4	77336	14.000000	0.307692	2091824	2061554
13414_8#32	18	5	13	1	1655	0.384615	0.076923	2091964	2091964
14555_3#62	115	81	34	4	8557	2.382353	0.117647	2091180	2091180
14566_4#91	35	0	35	0	969	0.000000	0.000000	2073635	2072664
14723_6#37	290	256	34	4	32363	7.529412	0.117647	2088265	2077986
14723_4#67	1282	1249	33	16	174067	37.848484	0.484848	2068995	2066384
14723_3#85	39	0	39	0	969	0.000000	0.000000	2086955	2085984
13415_5#36	436	395	41	7	82438	9.634147	0.170732	2086674	2070482
15731_8#52	2	0	2	0	89138	0.000000	0.000000	2075234	1986091
12837_2#70	30	8	22	1	9663	0.363636	0.045455	2084792	2075125
15841_3#6	1	0	1	0	114879	0.000000	0.000000	2070975	1959571
12837_4#82	564	536	28	8	86641	19.142857	0.285714	2085624	2085624
14410_8#32	389	341	48	4	117696	7.104167	0.083333	2083285	1995321
14566_6#63	9	0	9	0	67421	0.000000	0.000000	2082085	2014650
13470_1#16	21	0	21	0	0	0.000000	0.000000	2092261	2092261
12162_1#71	486	443	43	7	74022	10.302325	0.162791	2084809	2084809
18456_1#34	353	339	14	7	91944	24.214285	0.500000	2078474	2036077
14412_2#44	50	0	50	0	89040	0.000000	0.000000	2083885	1994841
15841_2#57	17	6	11	1	197328	0.545455	0.090909	2081145	1884755
15873_1#35	313	265	48	5	53815	5.520833	0.104167	2087831	2087831
13414_8#72	23	0	23	0	0	0.000000	0.000000	2093171	2093171
17870_7#152	41	26	15	1	42390	1.733333	0.066667	2088685	2046288
15731_8#27	1	0	1	0	89138	0.000000	0.000000	2075056	1985913
17059_6#30	12	0	12	0	197148	0.000000	0.000000	2086726	1889592
13415_5#93	50	4	46	1	89048	0.086957	0.021739	2072951	1983907
14257_1#19	259	222	37	4	26491	6.000000	0.108108	2089963	2073771
14723_4#10	1407	1376	31	17	261692	44.387096	0.548387	2044875	2034603
13415_4#54	1	0	1	0	41396	0.000000	0.000000	2088862	2047785
14913_4#63	378	347	31	5	49141	11.193548	0.161290	2087729	2086758
14566_4#13	34	5	29	1	475	0.172414	0.034483	2090794	2090794
15995_2#16	35	0	35	0	12663	0.000000	0.000000	2084015	2071700
15841_3#14	1	0	1	0	114879	0.000000	0.000000	2070784	1959236
14566_6#73	12	0	12	0	67421	0.000000	0.000000	2084256	2016821
15874_1#3	725	688	37	6	99262	18.594595	0.162162	2085017	2084046
17150_4#13	0	0	0	0	67421	0.000000	0.000000	2086066	2018631
N4	129	123	6	4	16188	20.500000	0.666667	2094662	2094662
N8	640	603	37	9	114879	16.297297	0.243243	2071970	2071970
N7	10	0	10	0	0	0.000000	0.000000	2096073	2096073
N6	1	0	1	0	0	0.000000	0.000000	2096656	2096656
N10	47	10	37	2	89138	0.270270	0.054054	2076298	1987254
N11	1	0	1	0	89040	0.000000	0.000000	2087335	1998291
N9	458	444	14	4	89040	31.714285	0.285714	2089908	2089908
N5	3	0	3	0	0	0.000000	0.000000	2098483	2098483
N3	8	0	8	0	0	0.000000	0.000000	2098936	2098936
N13	325	299	26	4	30266	11.500000	0.153846	2104032	2101421
N12	31	29	2	1	2610	14.500000	0.500000	2104233	2104233
N2	10	0	10	0	0	0.000000	0.000000	2104551	2104551
N17	29	28	1	2	10824	28.000000	2.000000	2093650	2093650
N16	18	0	18	0	0	0.000000	0.000000	2094060	2094060
N15	6	0	6	0	0	0.000000	0.000000	2094773	2094773
N23	0	0	0	0	67421	0.000000	0.000000	2087077	2019642
N22	95	57	38	3	67421	1.500000	0.078947	2087921	2020486
N24	2	0	2	0	67421	0.000000	0.000000	2085110	2017675
N21	452	440	12	14	67421	36.666668	1.166667	2089721	2080054
N20	81	78	3	4	9663	26.000000	1.333333	2091311	2091311
N19	1	0	1	0	0	0.000000	0.000000	2093779	2093779
N18	8	0	8	0	0	0.000000	0.000000	2093997	2093997
N14	4	0	4	0	0	0.000000	0.000000	2098629	2098629
N31	429	421	8	10	87952	52.625000	1.250000	2087281	2086310
N36	4	0	4	0	197148	0.000000	0.000000	2084095	1887370
N35	1428	1392	36	17	197148	38.666668	0.472222	2089736	2071584
N34	60	54	6	3	18148	9.000000	0.500000	2094472	2093501
N38	283	254	29	4	41396	8.758620	0.137931	2089755	2077410
N37	45	40	5	4	12663	8.000000	0.800000	2092791	2091820
N33	0	0	0	0	969	0.000000	0.000000	2096115	2095144
N32	0	0	0	0	969	0.000000	0.000000	2096171	2095200
N30	3	0	3	0	969	0.000000	0.000000	2096404	2095433
N29	4	0	4	0	969	0.000000	0.000000	2096552	2095581
N28	0	0	0	0	969	0.000000	0.000000	2096566	2095595
N41	2	0	2	0	969	0.000000	0.000000	2095715	2094744
N43	5	0	5	0	969	0.000000	0.000000	2093196	2092225
N42	2	0	2	0	969	0.000000	0.000000	2094092	2093121
N40	6	0	6	0	969	0.000000	0.000000	2098092	2097121
N44	280	247	33	5	42390	7.484848	0.151515	2091269	2090298
N39	2	0	2	0	969	0.000000	0.000000	2100643	2099672
N27	1	0	1	0	969	0.000000	0.000000	2100855	2099884
N26	25	18	7	2	969	2.571429	0.285714	2100871	2100871
N46	2	0	2	0	0	0.000000	0.000000	2094357	2094357
N49	0	0	0	0	0	0.000000	0.000000	2093953	2093953
N48	10	0	10	0	0	0.000000	0.000000	2095404	2095404
N50	6	0	6	0	0	0.000000	0.000000	2093989	2093989
N47	6	0	6	0	0	0.000000	0.000000	2095722	2095722
N45	2	0	2	0	0	0.000000	0.000000	2095952	2095952
N25	0	0	0	0	0	0.000000	0.000000	2101373	2101373
N1	0	0	0	0	0	0.000000	0.000000	2104987	2104987
