Node	Total SNPs	Num of SNPs inside recombinations	Num of SNPs outside recombinations	Num of Recombination Blocks	Bases in Recombinations	r/m	rho/theta	Genome Length	Bases in Clonal Frame
13414_2#91	1375	1344	31	10	835650	43.354839	0.322581	1981903	1332391
15682_2#68	11	0	11	0	619762	0.000000	0.000000	2068929	1465562
11658_2#1	38	13	25	2	622766	0.520000	0.080000	2043932	1449633
16043_2#60	139	100	39	3	413044	2.564103	0.076923	2063247	1659495
19084_7#168	27	0	27	0	609042	0.000000	0.000000	2045842	1452316
17150_4#44	347	342	5	3	658002	68.400002	0.600000	2040211	1432959
14673_1#84	9	0	9	0	689897	0.000000	0.000000	2022597	1356326
19341_3#1	85	49	36	1	575781	1.361111	0.027778	2060417	1496144
22841_1#176	424	370	54	4	587190	6.851852	0.074074	2049132	1509923
17175_5#20	0	0	0	0	836235	0.000000	0.000000	2000173	1211139
14566_5#88	770	742	28	8	680291	26.500000	0.285714	2061954	1503286
17150_4#57	377	350	27	3	597359	12.962963	0.111111	2073363	1506974
13710_1#45	8	0	8	0	689897	0.000000	0.000000	2037067	1372812
19084_8#33	101	68	33	1	612316	2.060606	0.030303	2046940	1455397
14566_6#20	857	845	12	12	769525	70.416664	1.000000	2053660	1364487
19341_2#74	13	0	13	0	419526	0.000000	0.000000	2094769	1677837
17059_7#34	36	16	20	2	819127	0.800000	0.100000	1984321	1206560
12838_1#73	17	0	17	0	689897	0.000000	0.000000	2021825	1355997
14555_3#14	246	231	15	5	595452	15.400000	0.333333	2075964	1516208
24775_1#85	141	110	31	1	705117	3.548387	0.032258	2022052	1360754
13414_2#67	132	122	10	2	694057	12.200000	0.200000	2023110	1356060
12162_1#83	6	0	6	0	786527	0.000000	0.000000	1985207	1236879
12291_4#38	9	0	9	0	689897	0.000000	0.000000	2042196	1375568
12291_4#89	10	0	10	0	689897	0.000000	0.000000	2023139	1356513
19084_8#158	34	5	29	1	480135	0.172414	0.034483	2078870	1605767
13470_1#47	0	0	0	0	575114	0.000000	0.000000	2077234	1513833
15682_2#79	16	0	16	0	698487	0.000000	0.000000	2019248	1346093
12291_1#7	5	0	5	0	622737	0.000000	0.000000	2053919	1459393
15531_4#78	0	0	0	0	645110	0.000000	0.000000	2025929	1413581
11657_8#4	122	82	40	4	702057	2.050000	0.100000	2040176	1372306
14913_3#89	13	0	13	0	783728	0.000000	0.000000	1989934	1241414
12837_1#22	139	119	20	4	581909	5.950000	0.200000	2079275	1516108
14913_5#30	12	0	12	0	697880	0.000000	0.000000	2064681	1382775
11658_2#72	3	0	3	0	689897	0.000000	0.000000	2042868	1375999
13414_2#83	107	85	22	3	697263	3.863636	0.136364	2035629	1370220
19084_8#135	245	219	26	6	722187	8.423077	0.230769	2011324	1319405
19084_7#43	39	24	15	1	690437	1.600000	0.066667	2044286	1376483
17150_4#14	15	0	15	0	782756	0.000000	0.000000	2005872	1255791
12291_1#11	30	14	16	2	632365	0.875000	0.125000	2039240	1438767
18090_2#72	84	63	21	2	438524	3.000000	0.095238	2077262	1643682
19341_2#93	23	0	23	0	525994	0.000000	0.000000	2027020	1534893
11511_8#59	14	0	14	0	689897	0.000000	0.000000	2065159	1390919
20925_3#7	764	727	37	10	789345	19.648649	0.270270	2027727	1368310
12291_4#65	366	357	9	6	723973	39.666668	0.666667	2034054	1370023
19341_3#116	137	115	22	2	578397	5.227273	0.090909	2047774	1483750
12837_5#69	31	13	18	1	573390	0.722222	0.055556	2078422	1515940
24775_1#65	34	6	28	1	690172	0.214286	0.035714	2032285	1370529
19341_3#14	0	0	0	0	689897	0.000000	0.000000	2041911	1373590
17794_7#113	57	31	26	1	652038	1.192308	0.038462	2013742	1407837
14410_5#3	663	627	36	4	707625	17.416666	0.111111	2022932	1410725
12299_1#8	22	0	22	0	689897	0.000000	0.000000	2040616	1374374
24775_1#61	55	41	14	3	690928	2.928571	0.214286	2035062	1372008
13415_5#59	0	0	0	0	575072	0.000000	0.000000	2076095	1512672
12291_5#1	92	78	14	3	690479	5.571429	0.214286	2038178	1374738
19341_3#113	0	0	0	0	689897	0.000000	0.000000	2043777	1375842
14913_5#95	14	0	14	0	724144	0.000000	0.000000	2023967	1343676
13415_5#66	646	607	39	8	689986	15.564102	0.205128	2059561	1445995
11511_8#40	319	307	12	6	742975	25.583334	0.500000	2053826	1384325
17175_7#15	278	257	21	12	643761	12.238095	0.571429	2072553	1454571
17175_4#17	7	0	7	0	782756	0.000000	0.000000	1984420	1240687
19341_3#117	27	5	22	1	574605	0.227273	0.045455	2061296	1496807
14673_1#67	358	342	16	4	716564	21.375000	0.250000	2038372	1373928
15841_4#41	2	0	2	0	773043	0.000000	0.000000	1993991	1266885
14257_1#8	115	96	19	3	574068	5.052631	0.157895	2055992	1495357
21999_7#110	19	0	19	0	689907	0.000000	0.000000	2044482	1376018
14673_4#32	21	0	21	0	689897	0.000000	0.000000	2040447	1374471
12837_1#20	3252	3068	184	42	1053296	16.673914	0.228261	1975320	1324736
12291_6#13	12	0	12	0	575072	0.000000	0.000000	2075461	1512825
21127_1#76	314	257	57	9	439544	4.508772	0.157895	2080776	1667009
18090_2#64	58	42	16	3	446616	2.625000	0.187500	2096032	1652037
17059_7#38	30	7	23	1	697880	0.304348	0.043478	2071736	1387780
17150_5#76	20	5	15	1	783740	0.333333	0.066667	1987259	1240482
17175_7#1	13	0	13	0	575072	0.000000	0.000000	2086193	1519754
14936_4#28	1621	1578	43	20	672534	36.697674	0.465116	2048546	1498074
12291_4#69	59	49	10	1	714279	4.900000	0.100000	2039527	1349808
18090_2#71	2	0	2	0	612418	0.000000	0.000000	2022507	1445999
17175_5#18	550	472	78	10	812954	6.051282	0.128205	2078230	1305865
13353_7#15	37	0	37	0	689897	0.000000	0.000000	2047822	1379141
12837_5#47	369	352	17	6	577914	20.705883	0.352941	2072443	1514330
17175_8#81	272	232	40	3	596765	5.800000	0.075000	2083323	1519360
11679_1#62	1	0	1	0	623274	0.000000	0.000000	2051314	1450822
19341_2#117	28	9	19	1	419526	0.473684	0.052632	2096199	1678813
16043_2#58	22	0	22	0	416621	0.000000	0.000000	2088067	1676645
14412_2#65	578	562	16	14	882189	35.125000	0.875000	1978697	1204046
17175_5#80	460	445	15	11	621994	29.666666	0.733333	2083847	1517336
15731_8#39	594	568	26	3	830742	21.846153	0.115385	1964835	1231113
11511_8#33	22	6	16	1	689897	0.375000	0.062500	2062507	1389087
13154_3#74	11	0	11	0	694401	0.000000	0.000000	2016139	1351728
12291_6#55	499	478	21	12	643250	22.761906	0.571429	2069364	1506685
11679_1#3	28	7	21	1	713920	0.333333	0.047619	2056326	1360222
15682_2#74	283	271	12	10	713335	22.583334	0.833333	2013970	1347210
14673_2#57	180	171	9	2	724612	19.000000	0.222222	2022337	1356221
14673_4#20	10	0	10	0	689897	0.000000	0.000000	2039414	1374052
12299_1#6	1	0	1	0	707029	0.000000	0.000000	2055318	1365948
22841_1#187	394	363	31	6	595554	11.709678	0.193548	2052400	1515416
14673_1#86	196	179	17	4	691919	10.529411	0.235294	2008730	1342893
13414_2#64	506	484	22	12	705155	22.000000	0.545455	2031210	1368462
21127_1#124	1510	1400	110	15	469367	12.727273	0.136364	1986881	1822654
22114_6#48	927	685	242	12	297301	2.830579	0.049587	2012482	1848774
13091_6#81	42	23	19	3	689897	1.210526	0.157895	2061529	1389093
17150_6#55	0	0	0	0	1006118	0.000000	0.000000	2010057	1045895
14673_3#10	404	342	62	5	526076	5.516129	0.080645	2016772	1534596
19084_8#13	63	0	63	0	622740	0.000000	0.000000	2044695	1448496
11511_8#9	45	29	16	3	715700	1.812500	0.187500	2030613	1340415
19084_7#158	21	0	21	0	622724	0.000000	0.000000	2045260	1448879
12299_1#70	104	92	12	2	690206	7.666667	0.166667	2058759	1387154
12291_4#9	82	63	19	4	610568	3.315789	0.210526	2041496	1446573
22841_1#119	14	0	14	0	689897	0.000000	0.000000	2042527	1375041
21127_1#99	1	0	1	0	690035	0.000000	0.000000	2019447	1353475
21127_1#29	7	0	7	0	721777	0.000000	0.000000	2020161	1322259
15682_1#67	15	0	15	0	619762	0.000000	0.000000	2049712	1446502
18090_2#65	33	15	18	1	530207	0.833333	0.055556	2026017	1530778
13415_7#83	16	0	16	0	573390	0.000000	0.000000	2076944	1514743
11658_2#84	243	219	24	5	691197	9.125000	0.208333	2057402	1387496
12291_2#44	0	0	0	0	632355	0.000000	0.000000	2022486	1425476
21242_2#153	12	0	12	0	689897	0.000000	0.000000	2043218	1375967
15608_3#47	2	0	2	0	689910	0.000000	0.000000	2039513	1373745
12291_1#52	1	0	1	0	622709	0.000000	0.000000	2045288	1450866
21053_8#173	50	0	50	0	573071	0.000000	0.000000	2080451	1516728
11679_1#27	7	0	7	0	694401	0.000000	0.000000	2036050	1370232
12291_4#13	771	743	28	11	742706	26.535715	0.392857	2029811	1369272
21127_1#41	9	0	9	0	619762	0.000000	0.000000	2072549	1470010
13154_2#84	0	0	0	0	416621	0.000000	0.000000	2089822	1677827
14410_7#64	404	378	26	11	679314	14.538462	0.423077	2023266	1437830
12291_1#44	0	0	0	0	632355	0.000000	0.000000	2041672	1440693
14410_8#16	508	487	21	4	619553	23.190475	0.190476	2070526	1510455
19084_8#110	50	10	40	1	622724	0.250000	0.025000	2049335	1452425
19084_8#25	320	288	32	3	626791	9.000000	0.093750	2083497	1518472
15531_7#7	16	0	16	0	586574	0.000000	0.000000	1972127	1440780
19341_3#43	308	281	27	5	579255	10.407408	0.185185	2059233	1498440
14673_2#76	7	0	7	0	689897	0.000000	0.000000	2040670	1374694
12837_4#22	861	851	10	11	634582	85.099998	1.100000	2072062	1511262
14673_2#29	4	0	4	0	689897	0.000000	0.000000	2041509	1375271
17175_7#81	268	242	26	4	593239	9.307693	0.153846	2081535	1516849
13414_2#22	53	12	41	2	573364	0.292683	0.048780	2078308	1516151
22027_1#142	501	460	41	8	578995	11.219512	0.195122	2059053	1520865
14723_6#68	5	0	5	0	689897	0.000000	0.000000	2022497	1356533
12837_5#57	497	473	24	7	648691	19.708334	0.291667	2065924	1511784
19341_3#112	21	0	21	0	689897	0.000000	0.000000	2044343	1376213
15874_1#44	178	163	15	3	586947	10.866667	0.200000	2049241	1488941
15682_1#73	32	8	24	1	515263	0.333333	0.041667	2064530	1558543
14673_1#48	2	0	2	0	689897	0.000000	0.000000	2040638	1374758
11679_1#74	13	0	13	0	622737	0.000000	0.000000	2040529	1447504
21127_1#79	2	0	2	0	690035	0.000000	0.000000	2018563	1353082
12291_6#76	230	211	19	3	802699	11.105263	0.157895	1990111	1246224
14410_8#91	15	0	15	0	783728	0.000000	0.000000	1985880	1238931
14913_7#70	8	0	8	0	786527	0.000000	0.000000	1992118	1240372
15682_1#56	131	70	61	3	522245	1.147541	0.049180	2036240	1541912
13710_2#34	12	0	12	0	689897	0.000000	0.000000	2021119	1355425
18090_2#154	18	0	18	0	619762	0.000000	0.000000	2075822	1470955
13415_8#64	12	0	12	0	697880	0.000000	0.000000	2065061	1383077
12837_2#24	650	631	19	11	673642	33.210526	0.578947	2070576	1467889
15682_1#61	84	83	1	2	698487	83.000000	2.000000	2018872	1344656
21999_8#83	2	0	2	0	689897	0.000000	0.000000	2037966	1372993
11657_4#55	109	86	23	3	730044	3.739130	0.130435	2023745	1331454
16043_2#65	36	8	28	1	416250	0.285714	0.035714	2092355	1681331
12291_5#45	78	61	17	3	689954	3.588235	0.176471	2039878	1374772
18090_2#42	368	339	29	5	431692	11.689655	0.172414	2082734	1670094
13154_3#44	33	14	19	2	689897	0.736842	0.105263	2061154	1388625
19341_3#37	27	0	27	0	574605	0.000000	0.000000	2064069	1499578
22841_1#110	356	324	32	11	588648	10.125000	0.343750	2048724	1516541
17150_6#89	5	0	5	0	587184	0.000000	0.000000	2076822	1501632
12291_4#53	11	0	11	0	689897	0.000000	0.000000	2054855	1384195
13353_7#78	464	430	34	5	706631	12.647058	0.147059	2019447	1358320
21999_8#68	186	163	23	2	694401	7.086957	0.086957	2033750	1372634
12291_4#82	17	0	17	0	689897	0.000000	0.000000	2041731	1374997
12290_2#17	412	389	23	15	781225	16.913044	0.652174	2048594	1382299
12162_1#60	11	0	11	0	782756	0.000000	0.000000	1983347	1239405
12837_5#72	1215	1160	55	18	638163	21.090910	0.327273	2048328	1486750
12299_1#43	62	41	21	4	713920	1.952381	0.190476	2027466	1338489
19084_7#115	119	80	39	4	417405	2.051282	0.102564	2096323	1684789
14673_1#52	389	380	9	2	694401	42.222221	0.222222	2034882	1374926
21127_1#30	16	0	16	0	619762	0.000000	0.000000	2073126	1470585
14673_1#2	38	0	38	0	689897	0.000000	0.000000	2022889	1356590
18090_2#61	2	0	2	0	525973	0.000000	0.000000	2027565	1535443
17150_6#62	0	0	0	0	1006118	0.000000	0.000000	2011325	1046468
11657_8#13	249	219	30	3	698144	7.300000	0.100000	2032560	1372059
17150_4#69	291	271	20	2	792380	13.550000	0.100000	1986129	1237536
16453_2#11	52	8	44	1	629653	0.181818	0.022727	2010245	1426648
12291_1#47	92	43	49	5	622789	0.877551	0.102041	2068978	1472345
12291_1#89	27	5	22	1	415089	0.227273	0.045455	2066412	1657100
13415_6#21	21	5	16	1	573390	0.312500	0.062500	2055002	1492591
21127_1#78	12	5	7	1	619914	0.714286	0.142857	2071426	1469321
12837_4#3	16	0	16	0	615308	0.000000	0.000000	2076689	1472582
11657_4#53	5	0	5	0	689897	0.000000	0.000000	2038921	1373884
14936_6#47	236	211	25	3	595321	8.440000	0.120000	2069112	1496102
13414_1#36	39	23	16	1	689897	1.437500	0.062500	2045495	1376468
17138_3#77	25	0	25	0	782756	0.000000	0.000000	1991466	1244051
19341_2#153	217	195	22	4	443472	8.863636	0.181818	2072786	1640273
15682_1#50	29	0	29	0	619762	0.000000	0.000000	2071342	1467682
12291_4#88	9	0	9	0	689897	0.000000	0.000000	2040859	1374353
11658_2#75	185	154	31	2	580076	4.967742	0.064516	2074705	1514530
12837_4#66	7	0	7	0	782756	0.000000	0.000000	1993437	1244586
21127_2#174	754	709	45	10	500853	15.755555	0.222222	2076344	1665048
14410_6#10	84	52	32	3	646777	1.625000	0.093750	2023466	1412635
20925_3#13	62	27	35	4	415597	0.771429	0.114286	2096327	1684124
15682_1#84	28	0	28	0	416621	0.000000	0.000000	2068996	1658210
19084_7#138	121	87	34	2	576003	2.558824	0.058824	2078904	1517573
13415_4#49	67	55	12	1	819127	4.583333	0.083333	1986096	1207385
14673_3#43	8	0	8	0	689897	0.000000	0.000000	2021492	1355543
18090_2#73	9	0	9	0	441293	0.000000	0.000000	2077811	1638883
17138_3#22	40	17	23	2	575071	0.739130	0.086957	2085622	1518989
12291_5#33	167	139	28	3	419849	4.964286	0.107143	2086064	1671712
12291_1#51	1	0	1	0	622709	0.000000	0.000000	2042645	1448890
15682_2#64	18	0	18	0	619762	0.000000	0.000000	2067461	1464818
11511_8#54	11	0	11	0	689897	0.000000	0.000000	2026037	1357950
21127_2#162	1684	1457	227	32	650509	6.418502	0.140969	1995807	1519450
24775_1#58	12	0	12	0	689897	0.000000	0.000000	2033388	1370803
12291_1#59	15	0	15	0	619762	0.000000	0.000000	2068964	1466750
11511_7#13	14	0	14	0	480135	0.000000	0.000000	2070460	1599501
14936_4#80	131	112	19	2	578612	5.894737	0.105263	2076141	1512823
15608_5#73	2	0	2	0	619762	0.000000	0.000000	2068506	1465320
19341_2#164	34	5	29	1	574605	0.172414	0.034483	2059653	1495014
12291_4#58	107	100	7	4	717163	14.285714	0.571429	2039025	1373880
13154_3#78	165	144	21	2	694722	6.857143	0.095238	2037467	1371257
14410_8#56	24	5	19	1	573390	0.263158	0.052632	2075621	1513892
13710_2#33	248	216	32	2	694923	6.750000	0.062500	2027298	1366340
11657_8#25	14	0	14	0	689897	0.000000	0.000000	2044168	1377041
15874_1#15	15	0	15	0	956260	0.000000	0.000000	1968295	1080455
17150_6#38	5	0	5	0	1006118	0.000000	0.000000	2009040	1044654
21999_7#162	21	0	21	0	689897	0.000000	0.000000	2043472	1376255
13414_4#42	12	0	12	0	689897	0.000000	0.000000	2043363	1376473
24775_1#71	16	0	16	0	689897	0.000000	0.000000	2032373	1370885
21127_1#39	203	188	15	4	631842	12.533334	0.266667	2064405	1463527
12837_3#87	1048	1036	12	14	664389	86.333336	1.166667	2065424	1504498
13091_6#82	23	7	16	1	694401	0.437500	0.062500	2055591	1382815
21127_1#87	24	5	19	1	620200	0.263158	0.052632	2069075	1467768
24775_1#90	19	0	19	0	574605	0.000000	0.000000	2054464	1492776
13415_6#51	17	0	17	0	575072	0.000000	0.000000	2077061	1513861
21999_7#173	8	0	8	0	689897	0.000000	0.000000	2043230	1375623
17794_8#24	886	852	34	10	761680	25.058823	0.294118	1989519	1382937
17150_6#70	0	0	0	0	1006118	0.000000	0.000000	2010087	1045855
21053_8#142	31	0	31	0	574605	0.000000	0.000000	2060803	1496676
17794_7#133	533	533	0	4	706913	0.000000	0.000000	2011947	1405874
12299_1#48	2	0	2	0	689954	0.000000	0.000000	2041687	1375502
18090_2#68	14	0	14	0	530207	0.000000	0.000000	2026169	1530114
15874_1#56	133	105	28	6	579922	3.750000	0.214286	2074833	1511928
17150_6#86	1	0	1	0	1006118	0.000000	0.000000	2010526	1046404
15841_4#33	11	0	11	0	773299	0.000000	0.000000	2029693	1288505
15531_4#87	257	228	29	4	619275	7.862069	0.137931	2023160	1452699
14913_7#67	22	0	22	0	575072	0.000000	0.000000	2077411	1514312
19084_8#176	211	197	14	2	703561	14.071428	0.142857	2025047	1358597
19341_2#73	22	0	22	0	525990	0.000000	0.000000	2029985	1537456
14673_3#5	13	0	13	0	689897	0.000000	0.000000	2022121	1355978
19341_3#45	25	0	25	0	689897	0.000000	0.000000	2042987	1376026
12162_1#1	17	0	17	0	782756	0.000000	0.000000	1986399	1240800
14555_3#50	14	0	14	0	697880	0.000000	0.000000	2063349	1381855
18090_2#67	13	0	13	0	525990	0.000000	0.000000	2027221	1535178
13470_1#40	0	0	0	0	575114	0.000000	0.000000	2076680	1513408
12162_1#15	31	0	31	0	689897	0.000000	0.000000	2039571	1373718
20925_3#30	25	0	25	0	575072	0.000000	0.000000	2086011	1519955
14936_6#72	17	0	17	0	783728	0.000000	0.000000	1992475	1242710
14566_4#59	57	45	12	3	711156	3.750000	0.250000	2060041	1370126
15841_4#67	3	0	3	0	773047	0.000000	0.000000	1986082	1260279
19341_2#172	21	0	21	0	574605	0.000000	0.000000	2061682	1497039
14673_4#19	22	0	22	0	689897	0.000000	0.000000	2039364	1373906
15682_2#13	9	0	9	0	689897	0.000000	0.000000	2020935	1355440
15608_3#66	6	0	6	0	689910	0.000000	0.000000	2039189	1373624
14723_6#54	873	821	52	7	623861	15.788462	0.134615	2053719	1518235
13415_7#73	1160	1145	15	11	862849	76.333336	0.733333	1986549	1240122
14520_7#52	6	0	6	0	712755	0.000000	0.000000	2002821	1331763
12291_3#45	12	0	12	0	622750	0.000000	0.000000	2044259	1450521
14566_6#89	484	439	45	1	611766	9.755555	0.022222	2074464	1512852
13415_5#65	801	778	23	4	608338	33.826088	0.173913	2049118	1499278
12837_2#14	592	579	13	5	629475	44.538460	0.384615	2068008	1469718
19084_8#109	32	0	32	0	622722	0.000000	0.000000	2049955	1453088
14412_1#5	21	8	13	1	575072	0.615385	0.076923	2075494	1512541
13414_3#13	541	522	19	7	575544	27.473684	0.368421	2068876	1508801
18090_2#63	4	0	4	0	612418	0.000000	0.000000	2022226	1445919
13710_1#44	75	32	43	3	545375	0.744186	0.069767	2054217	1516919
16043_2#61	1246	1225	21	6	639841	58.333332	0.285714	2048200	1493836
11658_2#74	161	159	2	2	696030	79.500000	1.000000	2030920	1370999
11893_8#11	49	27	22	3	648610	1.227273	0.136364	2031927	1412974
21999_8#109	10	0	10	0	689897	0.000000	0.000000	2032142	1370118
24775_1#66	3	0	3	0	689897	0.000000	0.000000	2032751	1369765
22841_1#24	1	0	1	0	689897	0.000000	0.000000	2039982	1373889
19084_7#177	7	0	7	0	689897	0.000000	0.000000	2042855	1374875
21999_7#176	28	0	28	0	689897	0.000000	0.000000	2025336	1357343
20925_3#28	298	249	49	3	580960	5.081633	0.061224	2080657	1519129
15608_5#90	22	0	22	0	515263	0.000000	0.000000	2064793	1560169
12837_4#2	151	125	26	4	632158	4.807693	0.153846	2069614	1452306
11679_1#58	7	0	7	0	609041	0.000000	0.000000	2040779	1450311
14566_5#42	426	407	19	5	586096	21.421053	0.263158	2050692	1493192
13710_1#47	395	360	35	8	757058	10.285714	0.228571	2016223	1327321
21127_1#18	383	356	27	5	456859	13.185185	0.185185	2082900	1667236
13415_8#47	8	0	8	0	782756	0.000000	0.000000	1992676	1244564
11893_8#15	2	0	2	0	689897	0.000000	0.000000	2056673	1384989
24775_1#89	19	0	19	0	619762	0.000000	0.000000	2063593	1463417
15531_5#55	3	0	3	0	755839	0.000000	0.000000	2017636	1297419
11511_8#4	13	0	13	0	689897	0.000000	0.000000	2062814	1389064
19341_2#80	40	19	21	3	446021	0.904762	0.142857	2094637	1650887
14555_3#13	166	150	16	2	575673	9.375000	0.125000	2056420	1494814
20925_3#66	129	86	43	3	689897	2.000000	0.069767	2048333	1378903
12291_4#79	8	0	8	0	689897	0.000000	0.000000	2040045	1374242
13670_3#16	301	299	2	2	429406	149.500000	1.000000	2083818	1675916
19341_3#11	22	0	22	0	574605	0.000000	0.000000	2062556	1498123
14566_5#44	258	223	35	9	614047	6.371428	0.257143	2077271	1514856
14673_2#34	1	0	1	0	692032	0.000000	0.000000	2040408	1372963
21999_8#86	2	0	2	0	689897	0.000000	0.000000	2039723	1374055
24775_1#92	27	0	27	0	574605	0.000000	0.000000	2055600	1493423
24775_1#110	107	70	37	4	697514	1.891892	0.108108	2026340	1364476
12291_6#39	18	0	18	0	697880	0.000000	0.000000	2061550	1380388
22114_6#42	487	459	28	11	504683	16.392857	0.392857	2067534	1600244
17794_8#138	27	0	27	0	689897	0.000000	0.000000	2017820	1353178
13414_3#16	25	0	25	0	689897	0.000000	0.000000	2014429	1345880
15841_4#24	5	0	5	0	724144	0.000000	0.000000	2021619	1343426
19084_7#163	145	120	25	2	615570	4.800000	0.080000	2043830	1452441
24775_1#108	13	0	13	0	689897	0.000000	0.000000	2034589	1371262
21127_1#27	4	0	4	0	619762	0.000000	0.000000	2071292	1469339
11511_8#38	44	15	29	3	689897	0.517241	0.103448	2048852	1374760
19341_3#62	26	0	26	0	574605	0.000000	0.000000	2054319	1489618
15608_4#70	654	601	53	14	495369	11.339622	0.264151	2085062	1677677
15378_2#24	1	0	1	0	645110	0.000000	0.000000	2017130	1409051
21127_1#42	9	0	9	0	619762	0.000000	0.000000	2072050	1469706
13154_2#29	6	0	6	0	622721	0.000000	0.000000	2045023	1450928
15277_1#17	28	4	24	1	689897	0.166667	0.041667	2043575	1377233
20925_3#61	77	0	77	0	619762	0.000000	0.000000	2077986	1472980
15608_2#38	454	437	17	5	480027	25.705883	0.294118	2083470	1668814
17150_4#11	348	316	32	3	586941	9.875000	0.093750	2082580	1516358
11679_1#28	6	0	6	0	689897	0.000000	0.000000	2038298	1367195
12291_1#48	1	0	1	0	414914	0.000000	0.000000	2082442	1672596
13415_6#25	6	0	6	0	782756	0.000000	0.000000	2007868	1256355
14566_4#80	626	604	22	14	860860	27.454546	0.636364	1982013	1237558
21053_8#180	806	760	46	10	512265	16.521740	0.217391	2062554	1650306
13415_8#65	15	0	15	0	782756	0.000000	0.000000	1991846	1244098
13710_2#58	34	0	34	0	692032	0.000000	0.000000	2036646	1371361
13154_2#85	0	0	0	0	416621	0.000000	0.000000	2089755	1677817
12299_1#80	796	768	28	14	537838	27.428572	0.500000	2047328	1582702
18090_2#180	384	353	31	2	425132	11.387096	0.064516	2107070	1692926
17175_6#65	384	352	32	8	826758	11.000000	0.250000	2002410	1253183
11657_4#74	20	5	15	1	622722	0.333333	0.066667	2044368	1450603
14566_5#14	12	0	12	0	782756	0.000000	0.000000	1983508	1239559
11658_2#66	235	198	37	8	708320	5.351351	0.216216	2055214	1384291
18090_2#150	16	0	16	0	559789	0.000000	0.000000	2024155	1500847
11658_2#60	28	17	11	1	694401	1.545455	0.090909	2036957	1371448
12291_4#74	6	0	6	0	692032	0.000000	0.000000	2051510	1380591
21053_8#169	25	0	25	0	689897	0.000000	0.000000	2042499	1375163
14723_6#65	197	144	53	7	434441	2.716981	0.132075	2085265	1673884
15531_5#66	16	0	16	0	586574	0.000000	0.000000	1968607	1431962
13415_5#11	12	0	12	0	575072	0.000000	0.000000	2059280	1495739
17175_5#27	2	0	2	0	836235	0.000000	0.000000	2001558	1212145
19341_3#114	25	0	25	0	689897	0.000000	0.000000	2041671	1374975
18090_2#59	4	0	4	0	525973	0.000000	0.000000	2023763	1534600
15531_7#4	57	14	43	1	609573	0.325581	0.023256	2012491	1448402
15608_2#50	327	303	24	6	513923	12.625000	0.250000	2011771	1534112
21053_8#139	35	0	35	0	619762	0.000000	0.000000	2071659	1469343
19341_3#118	30	5	25	1	574605	0.200000	0.040000	2062171	1497901
19084_8#139	57	14	43	2	694401	0.325581	0.046512	2040511	1372144
13414_4#34	22	9	13	1	573071	0.692308	0.076923	2079005	1516517
19341_2#148	53	29	24	1	420591	1.208333	0.041667	2097606	1682772
13154_3#88	99	60	39	6	689897	1.538462	0.153846	2063276	1390840
13415_7#72	28	4	24	1	782930	0.166667	0.041667	1990380	1242819
21127_2#143	242	191	51	3	564809	3.745098	0.058824	1988006	1472651
15682_2#27	6	0	6	0	619762	0.000000	0.000000	2072339	1468406
14412_2#61	615	605	10	13	762103	60.500000	1.300000	2051360	1370487
17138_4#8	325	290	35	5	582087	8.285714	0.142857	2065758	1500618
14566_5#47	420	402	18	3	809609	22.333334	0.166667	1968083	1223124
21999_8#32	49	34	15	1	694942	2.266667	0.066667	2034742	1370149
22027_1#141	446	425	21	10	592689	20.238094	0.476190	2053543	1515637
13470_1#75	905	862	43	23	924680	20.046511	0.534884	2015351	1171571
14673_3#71	5	0	5	0	692032	0.000000	0.000000	2039958	1372917
14913_3#94	25	0	25	0	783728	0.000000	0.000000	1990738	1242219
14673_4#30	22	0	22	0	689897	0.000000	0.000000	2040878	1374592
14673_1#81	14	0	14	0	689897	0.000000	0.000000	2022097	1356577
12162_1#3	49	0	49	0	956260	0.000000	0.000000	1967244	1080554
11679_1#13	347	317	30	9	734144	10.566667	0.300000	2054855	1385936
14555_3#94	2	0	2	0	575072	0.000000	0.000000	2074306	1511413
11511_8#57	5	0	5	0	689897	0.000000	0.000000	2056024	1381016
12291_6#60	17	0	17	0	580082	0.000000	0.000000	2053089	1487931
11657_4#93	50	18	32	3	609043	0.562500	0.093750	2043295	1452199
19084_7#128	7	0	7	0	622721	0.000000	0.000000	2044398	1447596
12837_5#78	38	19	19	2	700257	1.000000	0.105263	2047477	1365215
21485_4#3	1275	1186	89	19	579386	13.325843	0.213483	2035495	1679453
12162_1#86	26	0	26	0	697880	0.000000	0.000000	2060791	1380362
15378_2#56	1	0	1	0	755839	0.000000	0.000000	2010890	1294560
12291_6#85	14	0	14	0	587184	0.000000	0.000000	2070795	1497738
15682_2#1	426	399	27	3	710620	14.777778	0.111111	2037286	1372842
13414_3#95	39	0	39	0	689897	0.000000	0.000000	2025292	1358138
13415_6#23	60	44	16	1	782756	2.750000	0.062500	1986631	1238821
17150_6#33	7	0	7	0	580082	0.000000	0.000000	2062684	1493949
15873_3#18	6	0	6	0	712755	0.000000	0.000000	2006925	1333790
22841_3#164	778	739	39	4	551666	18.948717	0.102564	2070212	1598113
13154_3#43	244	226	18	2	689897	12.555555	0.111111	2061045	1387338
17059_8#69	12	0	12	0	786527	0.000000	0.000000	1980312	1234583
11657_4#30	4	0	4	0	694401	0.000000	0.000000	2042839	1375235
22667_7#134	31	0	31	0	544687	0.000000	0.000000	2068065	1526048
24775_1#62	196	175	21	5	715624	8.333333	0.238095	2024366	1365756
11511_8#37	34	12	22	2	689897	0.545455	0.090909	2062670	1389229
15682_1#81	6	0	6	0	689897	0.000000	0.000000	2020964	1355660
12291_4#33	8	0	8	0	689897	0.000000	0.000000	2046288	1378586
13710_1#33	117	78	39	2	691769	2.000000	0.051282	2042175	1374986
11657_4#95	13	0	13	0	689897	0.000000	0.000000	2040298	1374191
14520_7#80	1167	1096	71	15	697485	15.436620	0.211268	2021690	1408107
21053_8#188	897	863	34	13	649759	25.382353	0.382353	2068839	1511840
14673_1#82	198	170	28	6	708130	6.071429	0.214286	2041494	1374610
24775_1#73	22	0	22	0	574605	0.000000	0.000000	2054783	1492586
12291_4#27	29	6	23	1	689897	0.260870	0.043478	2063629	1389807
14673_2#88	4	0	4	0	689897	0.000000	0.000000	2039467	1374437
13415_4#40	5	0	5	0	575072	0.000000	0.000000	2076394	1513913
13154_3#49	221	201	20	5	720147	10.050000	0.250000	2049564	1381355
12837_1#25	16	0	16	0	782756	0.000000	0.000000	1993876	1244927
11657_8#14	7	0	7	0	689897	0.000000	0.000000	2013025	1345805
18090_1#133	155	119	36	2	574525	3.305556	0.055556	2055932	1493694
15841_4#22	136	103	33	3	956260	3.121212	0.090909	1969642	1080562
19341_2#69	64	37	27	1	436644	1.370370	0.037037	2094152	1659816
17059_8#38	23	0	23	0	697880	0.000000	0.000000	2068882	1386361
21127_1#95	3	0	3	0	619762	0.000000	0.000000	2071009	1468921
13091_6#26	269	245	24	5	604326	10.208333	0.208333	2066081	1527067
15841_4#6	18	0	18	0	782756	0.000000	0.000000	1990944	1243143
15682_1#72	6	0	6	0	698487	0.000000	0.000000	2020406	1346544
13414_8#86	74	51	23	1	575455	2.217391	0.043478	2075800	1513568
17794_7#66	481	356	125	9	337251	2.848000	0.072000	1973061	1768061
12291_4#16	780	761	19	13	772176	40.052631	0.684211	2035068	1371269
14520_6#44	21	0	21	0	782756	0.000000	0.000000	1990061	1242859
12291_4#15	13	6	7	1	689897	0.857143	0.142857	2062250	1389271
15531_4#42	2	0	2	0	645110	0.000000	0.000000	2023728	1412397
22027_1#44	216	193	23	9	498089	8.391304	0.391304	2074815	1603686
11658_2#24	36	14	22	1	622757	0.636364	0.045455	2042269	1449399
11511_8#48	15	0	15	0	689897	0.000000	0.000000	2061822	1387190
17150_5#32	106	68	38	4	578247	1.789474	0.105263	2082009	1519507
21999_8#40	261	249	12	3	711770	20.750000	0.250000	2033198	1374480
19084_8#31	37	0	37	0	603708	0.000000	0.000000	2064644	1470826
11658_2#19	15	0	15	0	689897	0.000000	0.000000	2041478	1375038
19084_7#77	17	0	17	0	689897	0.000000	0.000000	2042154	1375676
20925_3#77	39	0	39	0	574605	0.000000	0.000000	2061495	1497843
11511_8#96	40	21	19	2	622977	1.105263	0.105263	2066639	1466382
13091_6#36	10	0	10	0	603708	0.000000	0.000000	2059537	1466864
20925_3#48	722	675	47	13	527570	14.361702	0.276596	2069348	1657027
14913_3#25	103	89	14	1	573390	6.357143	0.071429	2076675	1514793
12299_1#41	18	8	10	1	700603	0.800000	0.100000	2060432	1388146
12291_3#48	19	0	19	0	622725	0.000000	0.000000	2041735	1447894
15682_2#55	18	0	18	0	689897	0.000000	0.000000	2041794	1375604
24775_1#76	24	0	24	0	689897	0.000000	0.000000	2032826	1370778
12291_1#4	11	0	11	0	622723	0.000000	0.000000	2043939	1450044
19084_7#122	21	0	21	0	610568	0.000000	0.000000	2057468	1462057
19084_8#44	24	0	24	0	689897	0.000000	0.000000	2045731	1377082
13154_2#18	18	13	5	1	695646	2.600000	0.200000	2040929	1374984
19341_3#63	1437	1381	56	20	751683	24.660715	0.357143	2061030	1504303
11657_4#40	10	0	10	0	689897	0.000000	0.000000	2052885	1380137
12299_1#61	158	148	10	1	689897	14.800000	0.100000	2039670	1373389
14673_3#7	15	0	15	0	689897	0.000000	0.000000	2039496	1374948
12291_6#52	296	277	19	7	833971	14.578947	0.368421	1985028	1241025
12837_2#39	8	0	8	0	782756	0.000000	0.000000	1992483	1244489
24775_1#75	24	0	24	0	574605	0.000000	0.000000	2054823	1493233
19084_7#147	34	0	34	0	544687	0.000000	0.000000	2069188	1526720
21999_8#115	18	0	18	0	689897	0.000000	0.000000	2034611	1371741
18090_2#60	803	770	33	6	499166	23.333334	0.181818	2079815	1669043
15682_2#75	14	0	14	0	698487	0.000000	0.000000	2016715	1342828
14412_1#7	17	0	17	0	782756	0.000000	0.000000	1990587	1243326
14555_3#82	29	0	29	0	575072	0.000000	0.000000	2076546	1513376
19341_3#51	45	27	18	3	690897	1.500000	0.166667	2019524	1351714
11658_2#18	3	0	3	0	623275	0.000000	0.000000	2051589	1451174
24775_1#70	21	5	16	1	574605	0.312500	0.062500	2053890	1492993
11657_4#96	39	15	24	2	609335	0.625000	0.083333	2061747	1468648
19341_3#66	45	18	27	2	574808	0.666667	0.074074	2061941	1497793
14673_3#8	19	0	19	0	689897	0.000000	0.000000	2039998	1374086
17794_8#23	3	0	3	0	645110	0.000000	0.000000	2011774	1406748
19084_8#178	21	0	21	0	692032	0.000000	0.000000	2046437	1375945
14412_1#69	5	0	5	0	782756	0.000000	0.000000	1990025	1242770
15531_5#52	3	0	3	0	645110	0.000000	0.000000	2024924	1413320
11657_4#27	24	0	24	0	689897	0.000000	0.000000	2039374	1367948
11658_2#10	391	369	22	11	680747	16.772728	0.500000	2034445	1448297
12299_1#7	0	0	0	0	707029	0.000000	0.000000	2053634	1365474
15682_2#67	9	0	9	0	689897	0.000000	0.000000	2021993	1356088
21127_1#81	431	400	31	5	675597	12.903226	0.161290	2059278	1459643
18090_2#70	28	4	24	1	441293	0.166667	0.041667	2099531	1659845
24775_1#95	20	0	20	0	689897	0.000000	0.000000	2033922	1371199
17175_6#10	430	410	20	5	794227	20.500000	0.250000	1988008	1242284
14673_1#71	16	8	8	1	715627	1.000000	0.125000	2040103	1349879
12162_1#63	12	0	12	0	587184	0.000000	0.000000	2070251	1497379
16453_2#20	718	685	33	5	699776	20.757576	0.151515	2007074	1404686
12291_4#61	9	0	9	0	689897	0.000000	0.000000	2040827	1374935
11822_1#78	1486	1457	29	12	529572	50.241379	0.413793	2062096	1651034
13414_2#20	15	0	15	0	689897	0.000000	0.000000	2041165	1375487
12299_1#57	25	0	25	0	689897	0.000000	0.000000	2042627	1376218
12291_2#48	0	0	0	0	414914	0.000000	0.000000	2076984	1667277
12162_1#45	23	5	18	1	575072	0.277778	0.055556	2074876	1512361
13414_2#15	16	0	16	0	689897	0.000000	0.000000	2044073	1376701
12291_6#67	22	0	22	0	782756	0.000000	0.000000	1986342	1241121
21127_1#80	14	0	14	0	721777	0.000000	0.000000	2039102	1340812
13154_2#17	5	0	5	0	689897	0.000000	0.000000	2041079	1374910
17175_6#18	1409	1383	26	13	839948	53.192307	0.500000	1977294	1234597
17150_5#80	207	178	29	3	576616	6.137931	0.103448	2082923	1519701
17150_4#31	13	0	13	0	782756	0.000000	0.000000	1987972	1242109
17175_7#65	15	0	15	0	782756	0.000000	0.000000	1992888	1245439
15378_2#59	2	0	2	0	755839	0.000000	0.000000	2012858	1295382
11657_2#24	824	773	51	7	518548	15.156863	0.137255	1996638	1523074
17175_5#69	35	0	35	0	782756	0.000000	0.000000	1987138	1241963
14673_1#62	6	0	6	0	689897	0.000000	0.000000	2022724	1356148
14566_6#44	316	282	34	6	609139	8.294118	0.176471	2051621	1489543
13414_8#22	179	156	23	3	590372	6.782609	0.130435	2067564	1502243
24775_1#100	21	5	16	1	690880	0.312500	0.062500	2033942	1371731
13414_2#63	96	56	40	1	689772	1.400000	0.025000	2041631	1375614
19341_3#115	43	0	43	0	574605	0.000000	0.000000	2061084	1496983
13154_3#75	6	0	6	0	689897	0.000000	0.000000	2023411	1356668
24775_1#59	0	0	0	0	689897	0.000000	0.000000	2030063	1367491
15608_4#65	22	0	22	0	689897	0.000000	0.000000	2023167	1356739
12299_1#38	3	0	3	0	689897	0.000000	0.000000	2042569	1375646
11658_2#14	549	522	27	4	622866	19.333334	0.148148	2033789	1444335
14723_6#67	5	0	5	0	689897	0.000000	0.000000	2022383	1356067
17059_6#4	797	764	33	12	620024	23.151516	0.363636	2076800	1516781
11679_1#53	6	0	6	0	689897	0.000000	0.000000	2020166	1355237
24775_1#93	14	0	14	0	689897	0.000000	0.000000	2033022	1370369
12291_4#66	99	81	18	2	696122	4.500000	0.111111	2039027	1372832
N12	43	35	8	3	648610	4.375000	0.375000	2035978	1418303
N16	0	0	0	0	755839	0.000000	0.000000	2019338	1298310
N15	918	893	25	9	755839	35.720001	0.360000	2021113	1409378
N21	1	0	1	0	645110	0.000000	0.000000	2029857	1415561
N22	3	0	3	0	645110	0.000000	0.000000	2026649	1414027
N20	0	0	0	0	645110	0.000000	0.000000	2037123	1419341
N19	6	0	6	0	645110	0.000000	0.000000	2038026	1419771
N18	58	11	47	2	645110	0.234043	0.042553	2040069	1421378
N17	0	0	0	0	644842	0.000000	0.000000	2042814	1422205
N14	12	0	12	0	644842	0.000000	0.000000	2044191	1422747
N23	543	514	29	5	712755	17.724138	0.172414	2009511	1400297
N13	0	0	0	0	644842	0.000000	0.000000	2045394	1423592
N11	0	0	0	0	644842	0.000000	0.000000	2049392	1424921
N10	0	0	0	0	644842	0.000000	0.000000	2049543	1424973
N9	0	0	0	0	644842	0.000000	0.000000	2049949	1425225
N8	23	12	11	1	644842	1.090909	0.090909	2050301	1425405
N7	142	140	2	2	644842	70.000000	1.000000	2051563	1447879
N6	13	12	1	1	622661	12.000000	1.000000	2051884	1452485
N5	203	167	36	3	618245	4.638889	0.083333	2052157	1468528
N4	0	0	0	0	602411	0.000000	0.000000	2053159	1469172
N3	3497	3334	163	45	602411	20.453987	0.276074	2053166	1787312
N30	0	0	0	0	1006118	0.000000	0.000000	2016069	1048631
N29	0	0	0	0	1006118	0.000000	0.000000	2018448	1049793
N28	0	0	0	0	1006118	0.000000	0.000000	2020063	1050665
N27	1536	1477	59	25	1006118	25.033897	0.423729	2021397	1175765
N26	2870	2682	188	39	877960	14.265958	0.207447	2039163	1535356
N36	7	0	7	0	786527	0.000000	0.000000	1994436	1242087
N35	125	114	11	1	786527	10.363636	0.090909	2004266	1251699
N34	3	0	3	0	782756	0.000000	0.000000	2005863	1252581
N33	2	0	2	0	782756	0.000000	0.000000	2006061	1252719
N40	0	0	0	0	819127	0.000000	0.000000	2000014	1215098
N39	369	363	6	6	819127	60.500000	1.000000	2002428	1249426
N42	0	0	0	0	782756	0.000000	0.000000	2000418	1249677
N43	6	0	6	0	782756	0.000000	0.000000	2003849	1251278
N41	0	0	0	0	782756	0.000000	0.000000	2007141	1253236
N38	3	0	3	0	782756	0.000000	0.000000	2010352	1254955
N52	2	0	2	0	956260	0.000000	0.000000	1971652	1082654
N51	2184	2171	13	16	956260	167.000000	1.230769	1975884	1243517
N53	1	0	1	0	782756	0.000000	0.000000	2005404	1251833
N50	2	0	2	0	782756	0.000000	0.000000	2010992	1254738
N58	4	0	4	0	782756	0.000000	0.000000	1997264	1249497
N57	0	0	0	0	782756	0.000000	0.000000	2000605	1251184
N56	0	0	0	0	782756	0.000000	0.000000	2002709	1252482
N55	0	0	0	0	782756	0.000000	0.000000	2006005	1254532
N59	1	0	1	0	782756	0.000000	0.000000	1996566	1246868
N54	0	0	0	0	782756	0.000000	0.000000	2008044	1255682
N49	9	0	9	0	782756	0.000000	0.000000	2020195	1262268
N63	15	5	10	1	782756	0.500000	0.100000	2021066	1263892
N65	2	0	2	0	782756	0.000000	0.000000	1992748	1244503
N64	0	0	0	0	782756	0.000000	0.000000	1998063	1247691
N62	5	0	5	0	782756	0.000000	0.000000	2026178	1266642
N72	445	392	53	11	836288	7.396226	0.207547	2006923	1255379
N71	0	0	0	0	783728	0.000000	0.000000	2015733	1260045
N70	0	0	0	0	783728	0.000000	0.000000	2018337	1261552
N74	0	0	0	0	783728	0.000000	0.000000	2005553	1250719
N73	2	0	2	0	783728	0.000000	0.000000	2006329	1251332
N69	0	0	0	0	783728	0.000000	0.000000	2020374	1262812
N75	5	0	5	0	783728	0.000000	0.000000	2004058	1250106
N68	96	90	6	1	783728	15.000000	0.166667	2021079	1264220
N67	12	12	0	1	782756	0.000000	0.000000	2021645	1264779
N66	2	0	2	0	782756	0.000000	0.000000	2022091	1265096
N61	0	0	0	0	782756	0.000000	0.000000	2040877	1278536
N76	5	0	5	0	782756	0.000000	0.000000	2003883	1251144
N60	21	0	21	0	782756	0.000000	0.000000	2041158	1278708
N48	2	0	2	0	782756	0.000000	0.000000	2051137	1286097
N47	0	0	0	0	782756	0.000000	0.000000	2051185	1286128
N78	0	0	0	0	782756	0.000000	0.000000	1997547	1247384
N79	2	0	2	0	782756	0.000000	0.000000	2088071	1312642
N77	15	4	11	1	782756	0.363636	0.090909	2089474	1313494
N46	0	0	0	0	782756	0.000000	0.000000	2095872	1317824
N45	5	0	5	0	782756	0.000000	0.000000	2095927	1317872
N44	0	0	0	0	782756	0.000000	0.000000	2096018	1317946
N37	1	0	1	0	782756	0.000000	0.000000	2096511	1318131
N32	2643	2406	237	35	782756	10.151898	0.147679	2096598	1445109
N82	4	0	4	0	773303	0.000000	0.000000	2035245	1292256
N81	1326	1177	149	23	773452	7.899329	0.154362	2036260	1375826
N80	318	291	27	12	677246	10.777778	0.444444	2041378	1399963
N31	1364	1288	76	24	655175	16.947369	0.315789	2099354	1584103
N25	257	184	73	14	517154	2.520548	0.191781	2101836	1607500
N24	1848	1712	136	29	496067	12.588235	0.213235	2101938	1827663
N2	1218	1135	83	26	275281	13.674699	0.313253	2103584	2103584
N85	405	378	27	3	586574	14.000000	0.111111	1987959	1472524
N84	2200	2078	122	19	545953	17.032787	0.155738	2005282	1799041
N83	858	820	38	10	219489	21.578947	0.263158	2019423	2019423
N87	677	604	73	13	173972	8.273973	0.178082	2038553	2022998
N93	499	461	38	4	612456	12.131579	0.105263	2026327	1501448
N92	295	291	4	8	559793	72.750000	2.000000	2030788	1539224
N95	4	0	4	0	525994	0.000000	0.000000	2032952	1539211
N98	20	0	20	0	525993	0.000000	0.000000	2030534	1537596
N99	143	132	11	3	530218	12.000000	0.272727	2030113	1537400
N97	1	0	1	0	525994	0.000000	0.000000	2034563	1540703
N96	0	0	0	0	525994	0.000000	0.000000	2035384	1541142
N94	2	0	2	0	525996	0.000000	0.000000	2037340	1542490
N91	52	36	16	3	526012	2.250000	0.187500	2038359	1547739
N90	975	946	29	7	521677	32.620689	0.241379	2052059	1687488
N89	999	923	76	17	386999	12.144737	0.223684	2062387	1785344
N102	135	126	9	6	504644	14.000000	0.666667	2028723	1543528
N101	1811	1748	63	18	502049	27.746031	0.285714	2034418	1715842
N107	0	0	0	0	416250	0.000000	0.000000	2107508	1693336
N110	3	0	3	0	480135	0.000000	0.000000	2071466	1600172
N114	17	9	8	1	550829	1.125000	0.125000	2063684	1525540
N115	4	0	4	0	550829	0.000000	0.000000	2068313	1528135
N113	793	784	9	10	550829	87.111115	1.111111	2070214	1597283
N117	0	0	0	0	482726	0.000000	0.000000	2079633	1605172
N116	6	6	0	1	482726	0.000000	0.000000	2081439	1605737
N112	77	73	4	1	482726	18.250000	0.250000	2082550	1608990
N111	1	0	1	0	480135	0.000000	0.000000	2083618	1609126
N109	590	585	5	11	480135	117.000000	2.200000	2084438	1655493
N122	4	0	4	0	544687	0.000000	0.000000	2080659	1538075
N121	0	0	0	0	544687	0.000000	0.000000	2081825	1539133
N123	11	0	11	0	544687	0.000000	0.000000	2069313	1526941
N120	47	43	4	2	544687	10.750000	0.500000	2082442	1539744
N119	759	753	6	10	544535	125.500000	1.666667	2082526	1649506
N124	1054	998	56	15	515263	17.821428	0.267857	2068761	1641094
N118	36	31	5	2	434807	6.200000	0.400000	2091870	1661579
N108	60	46	14	2	432037	3.285714	0.142857	2093787	1678960
N106	90	88	2	2	416250	44.000000	1.000000	2109911	1696436
N130	11	0	11	0	415004	0.000000	0.000000	2100118	1687575
N129	2	0	2	0	415004	0.000000	0.000000	2102085	1689241
N131	0	0	0	0	415004	0.000000	0.000000	2080944	1668733
N128	37	27	10	1	415004	2.700000	0.100000	2103006	1690086
N127	11	7	4	1	415004	1.750000	0.250000	2104306	1691087
N126	0	0	0	0	414870	0.000000	0.000000	2106335	1693040
N134	0	0	0	0	419835	0.000000	0.000000	2097631	1681364
N133	38	25	13	2	419835	1.923077	0.153846	2098307	1682819
N138	193	186	7	4	441293	26.571428	0.571429	2100464	1665421
N137	0	0	0	0	436644	0.000000	0.000000	2102934	1667844
N140	258	254	4	2	446021	63.500000	0.500000	2097622	1662937
N139	8	7	1	1	436644	7.000000	1.000000	2102042	1667190
N136	0	0	0	0	436644	0.000000	0.000000	2104868	1669742
N135	112	98	14	2	436644	7.000000	0.142857	2105053	1687453
N132	56	51	5	2	419051	10.200000	0.400000	2107360	1693931
N125	0	0	0	0	414870	0.000000	0.000000	2109486	1695869
N105	58	54	4	2	414870	13.500000	0.500000	2111403	1698091
N142	39	18	21	3	414914	0.857143	0.142857	2086480	1677073
N147	0	0	0	0	416621	0.000000	0.000000	2090140	1678159
N146	127	89	38	2	416621	2.342105	0.052632	2090793	1678715
N149	0	0	0	0	416621	0.000000	0.000000	2100132	1685291
N148	0	0	0	0	416621	0.000000	0.000000	2102011	1687080
N145	0	0	0	0	416621	0.000000	0.000000	2102550	1687608
N144	0	0	0	0	416621	0.000000	0.000000	2102807	1687857
N151	60	37	23	2	418362	1.608696	0.086957	2096882	1682102
N153	52	42	10	2	419526	4.200000	0.200000	2097372	1682841
N158	1666	1637	29	14	724144	56.448277	0.482759	2026701	1474384
N157	35	26	9	1	575387	2.888889	0.111111	2090509	1526698
N163	247	220	27	4	580082	8.148149	0.148148	2066938	1503465
N162	4	0	4	0	573390	0.000000	0.000000	2072763	1506179
N164	1	0	1	0	573390	0.000000	0.000000	2090029	1523810
N161	0	0	0	0	573390	0.000000	0.000000	2092586	1525621
N169	6	5	1	1	573390	5.000000	1.000000	2081826	1518300
N173	724	714	10	13	628491	71.400002	1.300000	2078118	1511788
N172	60	57	3	1	575054	19.000000	0.333333	2090702	1525116
N171	48	41	7	1	573390	5.857143	0.142857	2093557	1526580
N170	0	0	0	0	573390	0.000000	0.000000	2094904	1527262
N168	19	13	6	1	573390	2.166667	0.166667	2097895	1529320
N185	29	23	6	1	574697	3.833333	0.166667	2087331	1522391
N188	517	512	5	7	632158	102.400002	1.400000	2072083	1511777
N187	3	0	3	0	573390	0.000000	0.000000	2077252	1513684
N190	0	0	0	0	573390	0.000000	0.000000	2079283	1516839
N189	3	0	3	0	573390	0.000000	0.000000	2081380	1517809
N186	2	0	2	0	573390	0.000000	0.000000	2083963	1519388
N184	1	0	1	0	573390	0.000000	0.000000	2092933	1525439
N192	0	0	0	0	573390	0.000000	0.000000	2090012	1523408
N195	0	0	0	0	615308	0.000000	0.000000	2079174	1474305
N194	554	534	20	4	615308	26.700001	0.200000	2080131	1516055
N193	8	6	2	1	574006	3.000000	0.500000	2082027	1518548
N191	0	0	0	0	573390	0.000000	0.000000	2094316	1526827
N183	0	0	0	0	573390	0.000000	0.000000	2096300	1527742
N198	1	0	1	0	587184	0.000000	0.000000	2074627	1500522
N199	10	0	10	0	587184	0.000000	0.000000	2082823	1505883
N197	155	148	7	2	587184	21.142857	0.285714	2085204	1513394
N196	162	155	7	2	581361	22.142857	0.285714	2086623	1522589
N182	0	0	0	0	573390	0.000000	0.000000	2096522	1527927
N201	0	0	0	0	573390	0.000000	0.000000	2080344	1517498
N200	14	8	6	1	573390	1.333333	0.166667	2081166	1518045
N181	4	0	4	0	573390	0.000000	0.000000	2096612	1527987
N180	5	0	5	0	573390	0.000000	0.000000	2096618	1527993
N179	0	0	0	0	573390	0.000000	0.000000	2097232	1528607
N178	0	0	0	0	573390	0.000000	0.000000	2097237	1528612
N177	1	0	1	0	573390	0.000000	0.000000	2097281	1528655
N176	2	0	2	0	573390	0.000000	0.000000	2097537	1528736
N175	6	0	6	0	573390	0.000000	0.000000	2097550	1528745
N174	2	0	2	0	573390	0.000000	0.000000	2097656	1528839
N167	0	0	0	0	573390	0.000000	0.000000	2100821	1531432
N202	127	125	2	2	573390	62.500000	1.000000	2078632	1516378
N166	0	0	0	0	573390	0.000000	0.000000	2100959	1531491
N208	0	0	0	0	575072	0.000000	0.000000	2077162	1513570
N207	114	103	11	1	575072	9.363636	0.090909	2078304	1514358
N211	0	0	0	0	575072	0.000000	0.000000	2090190	1522845
N210	1	0	1	0	575072	0.000000	0.000000	2090814	1523293
N209	0	0	0	0	575072	0.000000	0.000000	2092027	1524051
N206	0	0	0	0	575072	0.000000	0.000000	2092342	1524266
N205	2	0	2	0	575072	0.000000	0.000000	2092391	1524313
N213	3	0	3	0	575072	0.000000	0.000000	2087787	1520747
N221	17	5	12	1	575114	0.416667	0.083333	2078194	1514603
N220	0	0	0	0	575072	0.000000	0.000000	2089061	1522173
N219	1	0	1	0	575072	0.000000	0.000000	2091357	1523668
N218	0	0	0	0	575072	0.000000	0.000000	2092038	1524192
N217	1	0	1	0	575072	0.000000	0.000000	2092393	1524422
N225	1	0	1	0	575072	0.000000	0.000000	2078786	1515184
N224	0	0	0	0	575072	0.000000	0.000000	2079649	1515737
N223	3	0	3	0	575072	0.000000	0.000000	2091436	1523574
N222	3	0	3	0	575072	0.000000	0.000000	2091642	1523711
N216	0	0	0	0	575072	0.000000	0.000000	2093524	1525148
N215	0	0	0	0	575072	0.000000	0.000000	2093573	1525175
N214	0	0	0	0	575072	0.000000	0.000000	2093629	1525193
N212	0	0	0	0	575072	0.000000	0.000000	2093752	1525283
N204	107	100	7	4	575072	14.285714	0.571429	2095025	1527731
N228	1	0	1	0	697880	0.000000	0.000000	2066312	1384056
N227	6	0	6	0	697880	0.000000	0.000000	2078204	1391892
N231	0	0	0	0	697880	0.000000	0.000000	2066736	1384360
N233	207	202	5	4	710135	40.400002	0.800000	2063346	1384107
N232	6	0	6	0	697880	0.000000	0.000000	2067754	1384640
N230	0	0	0	0	697880	0.000000	0.000000	2069720	1386148
N235	3	0	3	0	697880	0.000000	0.000000	2066360	1384047
N234	4	0	4	0	697880	0.000000	0.000000	2076879	1391350
N229	0	0	0	0	697880	0.000000	0.000000	2079289	1392593
N226	1076	1069	7	7	697880	152.714279	1.000000	2081630	1517637
N203	4	0	4	0	573390	0.000000	0.000000	2097826	1529581
N165	16	11	5	1	573390	2.200000	0.200000	2102495	1532772
N160	54	25	29	3	573390	0.862069	0.103448	2102881	1533467
N246	118	117	1	3	610568	117.000000	3.000000	2069673	1478239
N250	2	0	2	0	609043	0.000000	0.000000	2047076	1454531
N264	0	0	0	0	622724	0.000000	0.000000	2051867	1454307
N263	0	0	0	0	622724	0.000000	0.000000	2058403	1459682
N266	14	0	14	0	622723	0.000000	0.000000	2047040	1452336
N265	1	0	1	0	622724	0.000000	0.000000	2048906	1453918
N262	1	0	1	0	622725	0.000000	0.000000	2059684	1460733
N261	3	0	3	0	622728	0.000000	0.000000	2060051	1461026
N268	1	0	1	0	622722	0.000000	0.000000	2055065	1456599
N269	0	0	0	0	622722	0.000000	0.000000	2057024	1458639
N267	6	0	6	0	622728	0.000000	0.000000	2058823	1459762
N260	7	0	7	0	622735	0.000000	0.000000	2061765	1462128
N270	83	65	18	1	623293	3.611111	0.055556	2054310	1453525
N259	6	0	6	0	623093	0.000000	0.000000	2070511	1464130
N272	2	0	2	0	622739	0.000000	0.000000	2056070	1460984
N274	28	18	10	2	632365	1.800000	0.200000	2042800	1441301
N273	185	181	4	2	632369	45.250000	0.500000	2045171	1452711
N271	2	0	2	0	622741	0.000000	0.000000	2059183	1462971
N258	6	0	6	0	623099	0.000000	0.000000	2078558	1471216
N275	7	0	7	0	622747	0.000000	0.000000	2053613	1455891
N257	13	10	3	1	623102	3.333333	0.333333	2078739	1471275
N256	7	0	7	0	623109	0.000000	0.000000	2078775	1471306
N255	6	0	6	0	623115	0.000000	0.000000	2079086	1471603
N254	5	0	5	0	623120	0.000000	0.000000	2085225	1476625
N253	37	16	21	1	623143	0.761905	0.047619	2093069	1489803
N252	7	0	7	0	609397	0.000000	0.000000	2093233	1489950
N278	1	0	1	0	609043	0.000000	0.000000	2052157	1457334
N277	0	0	0	0	609043	0.000000	0.000000	2057605	1461902
N276	0	0	0	0	609043	0.000000	0.000000	2058405	1462438
N251	0	0	0	0	609397	0.000000	0.000000	2093593	1490125
N249	9	6	3	1	609400	2.000000	0.333333	2093630	1493866
N248	1	0	1	0	603708	0.000000	0.000000	2093655	1493876
N247	0	0	0	0	603708	0.000000	0.000000	2103007	1503227
N245	981	930	51	7	603708	18.235294	0.137255	2103046	1533747
N244	11	10	1	1	573071	10.000000	1.000000	2103112	1533782
N243	2	0	2	0	573071	0.000000	0.000000	2103164	1533817
N242	1	0	1	0	573071	0.000000	0.000000	2103170	1533823
N280	0	0	0	0	573071	0.000000	0.000000	2081064	1518200
N279	4	0	4	0	573071	0.000000	0.000000	2081701	1518696
N241	3	0	3	0	573071	0.000000	0.000000	2103202	1533852
N240	2	0	2	0	573071	0.000000	0.000000	2103238	1533872
N239	7	6	1	1	573071	6.000000	1.000000	2103582	1533996
N284	0	0	0	0	574605	0.000000	0.000000	2066108	1500570
N288	0	0	0	0	574605	0.000000	0.000000	2065254	1499797
N287	1	0	1	0	574605	0.000000	0.000000	2066483	1500975
N286	9	6	3	1	574605	2.000000	0.333333	2068371	1502126
N291	0	0	0	0	574605	0.000000	0.000000	2064963	1499617
N293	1	0	1	0	574605	0.000000	0.000000	2063955	1499029
N295	0	0	0	0	574605	0.000000	0.000000	2063466	1498641
N294	0	0	0	0	574605	0.000000	0.000000	2064255	1499266
N292	0	0	0	0	574605	0.000000	0.000000	2066690	1500943
N290	1	0	1	0	574605	0.000000	0.000000	2068033	1501917
N298	2	0	2	0	574605	0.000000	0.000000	2065639	1500218
N299	0	0	0	0	574605	0.000000	0.000000	2066280	1500905
N297	0	0	0	0	574605	0.000000	0.000000	2067908	1501946
N296	0	0	0	0	574605	0.000000	0.000000	2068426	1502390
N289	0	0	0	0	574605	0.000000	0.000000	2069976	1503443
N285	0	0	0	0	574605	0.000000	0.000000	2071363	1504463
N283	142	132	10	3	574605	13.200000	0.300000	2071812	1505250
N304	4	0	4	0	619762	0.000000	0.000000	2081324	1474726
N303	0	0	0	0	619762	0.000000	0.000000	2082192	1475201
N308	16	0	16	0	619762	0.000000	0.000000	2075113	1471378
N307	1	0	1	0	619762	0.000000	0.000000	2076395	1471945
N312	6	0	6	0	619762	0.000000	0.000000	2074528	1471133
N311	19	0	19	0	619762	0.000000	0.000000	2076660	1472112
N310	4	0	4	0	619762	0.000000	0.000000	2077655	1472700
N309	0	0	0	0	619762	0.000000	0.000000	2078722	1473491
N306	0	0	0	0	619762	0.000000	0.000000	2080289	1474256
N305	13	0	13	0	619762	0.000000	0.000000	2081421	1475312
N302	1	0	1	0	619762	0.000000	0.000000	2086943	1478551
N315	1	0	1	0	619762	0.000000	0.000000	2074022	1469455
N316	2	0	2	0	619762	0.000000	0.000000	2071068	1466855
N314	1	0	1	0	619762	0.000000	0.000000	2075597	1470376
N313	35	0	35	0	619762	0.000000	0.000000	2075903	1470555
N301	10	0	10	0	619762	0.000000	0.000000	2090067	1480581
N319	1	0	1	0	619762	0.000000	0.000000	2077579	1472384
N325	1	0	1	0	692032	0.000000	0.000000	2054155	1381965
N324	1	0	1	0	692032	0.000000	0.000000	2063048	1386437
N326	2	0	2	0	692032	0.000000	0.000000	2043430	1375221
N323	102	90	12	1	692032	7.500000	0.083333	2064364	1389022
N322	33	27	6	1	689897	4.500000	0.166667	2076438	1396537
N330	0	0	0	0	689897	0.000000	0.000000	2045527	1377015
N329	1	0	1	0	689897	0.000000	0.000000	2046591	1377656
N328	25	0	25	0	689897	0.000000	0.000000	2047570	1378138
N334	0	0	0	0	694401	0.000000	0.000000	2058673	1384573
N333	2	0	2	0	694401	0.000000	0.000000	2062080	1386156
N332	412	392	20	2	694401	19.600000	0.100000	2069293	1394181
N336	81	54	27	2	689897	2.000000	0.074074	2043621	1374675
N343	0	0	0	0	689897	0.000000	0.000000	2045810	1377304
N345	11	0	11	0	689897	0.000000	0.000000	2042089	1375091
N344	0	0	0	0	689897	0.000000	0.000000	2045934	1377396
N342	2	0	2	0	689897	0.000000	0.000000	2049058	1379016
N341	0	0	0	0	689897	0.000000	0.000000	2050596	1380182
N340	0	0	0	0	689897	0.000000	0.000000	2050755	1380225
N339	8	0	8	0	689897	0.000000	0.000000	2050865	1380310
N338	18	0	18	0	689897	0.000000	0.000000	2051262	1380522
N349	13	0	13	0	713920	0.000000	0.000000	2067701	1365259
N348	0	0	0	0	713920	0.000000	0.000000	2074497	1371694
N347	1340	1318	22	9	713920	59.909092	0.409091	2074869	1394392
N361	4	0	4	0	689897	0.000000	0.000000	2026618	1358676
N360	1	0	1	0	689897	0.000000	0.000000	2028017	1359642
N363	2	0	2	0	689897	0.000000	0.000000	2017763	1348571
N362	2	0	2	0	689897	0.000000	0.000000	2018527	1349181
N359	1	0	1	0	689897	0.000000	0.000000	2031517	1361693
N364	109	90	19	1	689897	4.736842	0.052632	2043135	1369741
N358	16	0	16	0	689897	0.000000	0.000000	2047508	1372410
N372	0	0	0	0	689897	0.000000	0.000000	2024561	1357327
N371	18	0	18	0	689897	0.000000	0.000000	2058760	1382357
N373	3	0	3	0	689897	0.000000	0.000000	2035909	1363452
N370	1	0	1	0	689897	0.000000	0.000000	2066145	1386164
N369	1	0	1	0	689897	0.000000	0.000000	2074260	1393528
N368	0	0	0	0	689897	0.000000	0.000000	2078887	1397995
N374	3	0	3	0	689897	0.000000	0.000000	2033681	1362097
N367	10	0	10	0	689897	0.000000	0.000000	2079228	1398213
N366	0	0	0	0	689897	0.000000	0.000000	2079260	1398232
N377	0	0	0	0	689897	0.000000	0.000000	2024890	1357705
N376	19	0	19	0	689897	0.000000	0.000000	2025958	1358469
N375	1	0	1	0	689897	0.000000	0.000000	2026500	1358729
N365	2	0	2	0	689897	0.000000	0.000000	2079437	1398357
N357	1	0	1	0	689897	0.000000	0.000000	2081334	1399683
N356	5	0	5	0	689897	0.000000	0.000000	2081468	1399792
N355	12	0	12	0	689897	0.000000	0.000000	2081477	1399797
N354	0	0	0	0	689897	0.000000	0.000000	2082006	1400273
N353	0	0	0	0	689897	0.000000	0.000000	2082438	1400597
N381	4	0	4	0	698487	0.000000	0.000000	2022911	1347591
N382	0	0	0	0	698487	0.000000	0.000000	2023106	1348313
N380	163	158	5	1	698487	31.600000	0.200000	2025120	1357912
N385	0	0	0	0	689897	0.000000	0.000000	2025416	1357512
N384	2	0	2	0	689897	0.000000	0.000000	2026581	1358246
N383	0	0	0	0	689897	0.000000	0.000000	2027314	1358771
N379	47	22	25	3	689897	0.880000	0.120000	2028765	1359825
N378	5	0	5	0	689897	0.000000	0.000000	2029491	1360446
N352	34	0	34	0	689897	0.000000	0.000000	2082532	1400670
N351	3	0	3	0	689897	0.000000	0.000000	2082688	1400823
N388	20	5	15	1	689907	0.333333	0.066667	2045838	1376762
N391	1	0	1	0	689897	0.000000	0.000000	2043825	1370456
N394	170	166	4	1	691692	41.500000	0.250000	2064312	1393181
N398	1	0	1	0	689897	0.000000	0.000000	2041815	1375926
N399	2	0	2	0	689897	0.000000	0.000000	2045234	1378132
N397	0	0	0	0	689897	0.000000	0.000000	2046108	1378575
N396	89	44	45	3	689897	0.977778	0.066667	2065966	1391064
N405	4	0	4	0	689897	0.000000	0.000000	2043193	1375974
N404	2	0	2	0	689897	0.000000	0.000000	2044949	1377102
N403	0	0	0	0	689897	0.000000	0.000000	2045694	1377612
N402	2	0	2	0	689897	0.000000	0.000000	2065708	1390018
N401	9	0	9	0	689897	0.000000	0.000000	2065866	1390143
N412	0	0	0	0	689897	0.000000	0.000000	2052037	1381200
N415	2	0	2	0	689897	0.000000	0.000000	2050026	1380235
N414	1	0	1	0	689897	0.000000	0.000000	2051332	1380865
N413	0	0	0	0	689897	0.000000	0.000000	2052604	1381532
N411	0	0	0	0	689897	0.000000	0.000000	2056911	1384234
N410	0	0	0	0	689897	0.000000	0.000000	2057528	1384601
N409	8	0	8	0	689897	0.000000	0.000000	2058280	1385020
N418	5	0	5	0	689897	0.000000	0.000000	2046800	1377937
N421	321	304	17	9	714279	17.882353	0.529412	2042922	1375619
N420	8	0	8	0	689897	0.000000	0.000000	2046174	1378096
N423	36	0	36	0	689897	0.000000	0.000000	2065933	1391183
N425	378	367	11	2	694401	33.363636	0.181818	2039549	1377626
N429	4	0	4	0	689897	0.000000	0.000000	2051573	1380573
N431	870	859	11	4	730044	78.090912	0.363636	2027102	1372101
N442	37	26	11	2	689910	2.363636	0.181818	2041552	1374915
N443	15	5	10	1	689954	0.500000	0.100000	2044393	1377198
N441	0	0	0	0	689897	0.000000	0.000000	2046115	1377727
N440	2	0	2	0	689897	0.000000	0.000000	2053712	1381926
N453	4	0	4	0	689897	0.000000	0.000000	2042810	1373864
N458	0	0	0	0	689897	0.000000	0.000000	2045552	1377555
N457	1	0	1	0	689897	0.000000	0.000000	2053613	1381918
N456	0	0	0	0	689897	0.000000	0.000000	2054236	1382427
N459	1	0	1	0	689897	0.000000	0.000000	2045051	1377406
N455	0	0	0	0	689897	0.000000	0.000000	2055512	1383155
N454	0	0	0	0	689897	0.000000	0.000000	2056401	1383545
N452	1	0	1	0	689897	0.000000	0.000000	2058910	1384867
N451	2	0	2	0	689897	0.000000	0.000000	2062554	1387255
N450	0	0	0	0	689897	0.000000	0.000000	2068448	1391553
N449	19	0	19	0	689897	0.000000	0.000000	2076364	1396862
N462	187	166	21	8	707029	7.904762	0.380952	2060655	1387109
N467	5	0	5	0	689897	0.000000	0.000000	2043391	1376423
N466	0	0	0	0	689897	0.000000	0.000000	2044931	1377230
N470	0	0	0	0	689897	0.000000	0.000000	2045576	1377856
N469	0	0	0	0	689897	0.000000	0.000000	2046176	1378202
N468	2	0	2	0	689897	0.000000	0.000000	2049582	1380145
N465	0	0	0	0	689897	0.000000	0.000000	2050082	1380412
N464	0	0	0	0	689897	0.000000	0.000000	2050409	1380586
N471	35	4	31	1	690035	0.129032	0.032258	2022314	1355105
N463	2	0	2	0	689897	0.000000	0.000000	2058238	1384409
N461	18	0	18	0	689897	0.000000	0.000000	2076460	1396177
N480	1	0	1	0	689897	0.000000	0.000000	2058687	1386374
N479	2	0	2	0	689897	0.000000	0.000000	2059218	1386661
N478	0	0	0	0	689897	0.000000	0.000000	2059627	1386848
N477	0	0	0	0	689897	0.000000	0.000000	2060156	1387190
N476	0	0	0	0	689897	0.000000	0.000000	2061295	1387865
N475	0	0	0	0	689897	0.000000	0.000000	2061438	1387949
N474	0	0	0	0	689897	0.000000	0.000000	2061532	1388008
N473	3	0	3	0	689897	0.000000	0.000000	2061612	1388079
N472	20	7	13	1	689897	0.538462	0.076923	2061662	1388107
N460	2	0	2	0	689897	0.000000	0.000000	2077521	1396917
N448	3	0	3	0	689897	0.000000	0.000000	2080784	1399166
N483	32	25	7	2	694401	3.571429	0.285714	2039286	1372819
N482	0	0	0	0	694401	0.000000	0.000000	2040878	1373970
N481	395	392	3	2	694401	130.666672	0.666667	2042253	1379254
N447	3	0	3	0	689897	0.000000	0.000000	2081212	1399579
N446	2	0	2	0	689897	0.000000	0.000000	2081377	1399694
N445	0	0	0	0	689897	0.000000	0.000000	2083063	1400973
N485	32	25	7	1	689897	3.571429	0.142857	2043808	1376746
N489	17	0	17	0	689897	0.000000	0.000000	2065833	1390802
N488	7	0	7	0	689897	0.000000	0.000000	2069759	1393590
N494	9	0	9	0	689897	0.000000	0.000000	2045214	1376351
N496	0	0	0	0	689897	0.000000	0.000000	2052952	1381194
N495	5	0	5	0	689897	0.000000	0.000000	2053530	1381461
N493	9	0	9	0	689897	0.000000	0.000000	2055247	1382350
N492	4	0	4	0	689897	0.000000	0.000000	2057760	1383946
N497	0	0	0	0	689897	0.000000	0.000000	2044437	1376843
N491	2	0	2	0	689897	0.000000	0.000000	2058326	1384275
N500	375	350	25	2	721777	14.000000	0.080000	2042619	1374453
N499	3	0	3	0	689897	0.000000	0.000000	2054987	1382150
N498	6	0	6	0	689897	0.000000	0.000000	2058027	1384435
N490	5	0	5	0	689897	0.000000	0.000000	2061318	1386482
N487	0	0	0	0	689897	0.000000	0.000000	2081642	1400069
N486	3	0	3	0	689897	0.000000	0.000000	2081763	1400156
N484	21	0	21	0	689897	0.000000	0.000000	2082266	1400521
N444	2	0	2	0	689897	0.000000	0.000000	2086663	1403520
N439	0	0	0	0	689897	0.000000	0.000000	2086784	1403619
N438	2	0	2	0	689897	0.000000	0.000000	2086856	1403688
N437	25	15	10	2	689897	1.500000	0.200000	2087134	1403957
N436	0	0	0	0	689897	0.000000	0.000000	2087159	1403980
N435	0	0	0	0	689897	0.000000	0.000000	2087255	1404075
N434	0	0	0	0	689897	0.000000	0.000000	2087510	1404312
N433	0	0	0	0	689897	0.000000	0.000000	2087669	1404456
N432	0	0	0	0	689897	0.000000	0.000000	2087754	1404530
N430	0	0	0	0	689897	0.000000	0.000000	2087766	1404535
N428	0	0	0	0	689897	0.000000	0.000000	2087793	1404560
N501	4	0	4	0	689897	0.000000	0.000000	2045904	1377871
N427	5	0	5	0	689897	0.000000	0.000000	2087858	1404620
N502	384	377	7	2	693884	53.857143	0.285714	2040997	1378222
N426	2	0	2	0	689897	0.000000	0.000000	2088528	1404726
N424	5	5	0	1	689897	0.000000	0.000000	2088531	1404727
N422	1	0	1	0	689897	0.000000	0.000000	2088831	1404892
N419	0	0	0	0	689897	0.000000	0.000000	2088980	1405026
N417	0	0	0	0	689897	0.000000	0.000000	2089003	1405030
N416	2	0	2	0	689897	0.000000	0.000000	2089003	1405030
N408	2	0	2	0	689897	0.000000	0.000000	2089150	1405154
N407	29	0	29	0	689897	0.000000	0.000000	2089242	1405211
N406	2	0	2	0	689897	0.000000	0.000000	2089414	1405286
N400	0	0	0	0	689897	0.000000	0.000000	2090260	1405361
N395	22	0	22	0	689897	0.000000	0.000000	2090335	1405422
N393	7	0	7	0	689897	0.000000	0.000000	2090449	1405526
N392	2	0	2	0	689897	0.000000	0.000000	2090834	1405814
N390	8	5	3	1	689897	1.666667	0.333333	2090939	1405913
N389	4	0	4	0	689897	0.000000	0.000000	2090939	1405913
N387	1	0	1	0	689897	0.000000	0.000000	2091207	1406050
N386	23	0	23	0	689897	0.000000	0.000000	2091269	1406056
N350	11	0	11	0	689897	0.000000	0.000000	2091607	1406300
N346	5	0	5	0	689897	0.000000	0.000000	2091940	1406309
N337	2	0	2	0	689897	0.000000	0.000000	2092209	1406402
N335	2	0	2	0	689897	0.000000	0.000000	2092210	1406403
N331	2	0	2	0	689897	0.000000	0.000000	2092254	1406447
N327	4	0	4	0	689897	0.000000	0.000000	2092324	1406504
N321	18	5	13	1	689897	0.384615	0.076923	2092468	1406702
N320	1047	1005	42	4	689772	23.928572	0.095238	2092468	1475753
N318	0	0	0	0	619762	0.000000	0.000000	2105824	1488442
N317	0	0	0	0	619762	0.000000	0.000000	2105825	1488442
N300	882	870	12	10	619762	72.500000	0.833333	2106201	1534354
N282	20	20	0	1	574133	0.000000	0.000000	2106813	1535782
N281	11	11	0	1	573071	0.000000	0.000000	2106825	1535794
N238	0	0	0	0	573071	0.000000	0.000000	2107574	1536347
N237	0	0	0	0	573071	0.000000	0.000000	2107596	1536351
N236	4	0	4	0	573071	0.000000	0.000000	2107615	1536370
N159	54	45	9	1	573071	5.000000	0.111111	2108637	1538618
N156	1609	1581	28	31	571665	56.464287	1.107143	2108668	1693475
N155	0	0	0	0	416621	0.000000	0.000000	2109267	1693616
N154	2	0	2	0	416621	0.000000	0.000000	2109275	1693624
N152	1	0	1	0	416621	0.000000	0.000000	2109814	1693918
N150	6	5	1	1	416621	5.000000	1.000000	2110078	1693959
N143	113	100	13	3	416621	7.692307	0.230769	2110175	1696267
N141	0	0	0	0	414398	0.000000	0.000000	2110185	1696276
N104	185	179	6	2	414398	29.833334	0.333333	2113402	1700787
N103	777	735	42	12	413044	17.500000	0.285714	2113402	1783192
N100	654	581	73	15	330561	7.958904	0.205479	2113421	1830860
N88	1762	1592	170	27	282765	9.364706	0.158824	2113530	2097975
N86	102	80	22	6	15549	3.636364	0.272727	2113845	2113845
N1	0	0	0	0	0	0.000000	0.000000	2114509	2114509
