Node	Total SNPs	Num of SNPs inside recombinations	Num of SNPs outside recombinations	Num of Recombination Blocks	Bases in Recombinations	r/m	rho/theta	Genome Length	Bases in Clonal Frame
17794_8#51	3	0	3	0	684752	0.000000	0.000000	1972377	1345551
15873_4#81	4	0	4	0	684752	0.000000	0.000000	1982941	1351956
14913_7#10	256	219	37	3	724371	5.918919	0.081081	1949783	1290871
17138_4#28	2	0	2	0	576265	0.000000	0.000000	1991858	1461464
17966_5#15	1036	996	40	15	917884	24.900000	0.375000	2011191	1186169
14913_4#56	27	0	27	0	773580	0.000000	0.000000	1927974	1204006
17150_6#60	125	110	15	3	1004854	7.333333	0.200000	1911703	1005810
15995_1#50	36	0	36	0	677787	0.000000	0.000000	1972291	1348008
15841_5#65	1	0	1	0	902551	0.000000	0.000000	1922103	1083960
9789_5#7	4	0	4	0	870178	0.000000	0.000000	2014990	1181985
17150_6#22	36	15	21	2	729134	0.714286	0.095238	1935372	1264395
13470_1#32	8	0	8	0	688027	0.000000	0.000000	1957359	1334766
19183_3#93	84	70	14	4	690652	5.000000	0.285714	1970444	1345271
16399_7#73	1	0	1	0	684752	0.000000	0.000000	1984738	1351948
14913_5#14	1698	1665	33	20	693704	50.454544	0.606061	1984777	1452690
17150_6#79	0	0	0	0	855561	0.000000	0.000000	1936273	1168942
17150_4#81	630	560	70	9	771320	8.000000	0.128571	1940792	1287994
15995_2#86	26	0	26	0	773580	0.000000	0.000000	1916880	1195821
17059_6#5	387	342	45	6	749291	7.600000	0.133333	1944922	1292147
13415_5#12	3602	3272	330	64	903821	9.915152	0.193939	1926413	1532376
17059_7#84	322	304	18	2	780216	16.888889	0.111111	1918269	1197558
17059_8#19	11	0	11	0	692883	0.000000	0.000000	1973640	1333747
17059_6#78	41	10	31	1	678100	0.322581	0.032258	1975834	1350678
17138_4#16	14	0	14	0	769107	0.000000	0.000000	1947880	1252181
17175_4#15	531	488	43	13	632152	11.348837	0.302326	1988974	1459482
17794_8#43	6	0	6	0	685156	0.000000	0.000000	1971732	1345057
15841_5#68	5	0	5	0	773580	0.000000	0.000000	1925968	1202516
15841_3#42	5	0	5	0	677768	0.000000	0.000000	1976043	1348736
14410_4#18	260	236	24	9	762674	9.833333	0.375000	1994043	1318138
14520_5#35	0	0	0	0	823264	0.000000	0.000000	1984108	1216901
18456_1#163	1332	1257	75	28	757665	16.760000	0.373333	1924827	1332588
17794_8#75	22	0	22	0	684752	0.000000	0.000000	1971455	1345519
12837_3#83	13	0	13	0	768907	0.000000	0.000000	1952173	1254140
15531_4#16	1	0	1	0	766408	0.000000	0.000000	2040993	1290478
17428_8#141	6	0	6	0	823264	0.000000	0.000000	1965752	1206770
15873_4#75	1	0	1	0	684752	0.000000	0.000000	1982985	1351903
14913_7#15	9	0	9	0	773580	0.000000	0.000000	1928191	1204630
17150_5#90	141	107	34	2	678029	3.147059	0.058824	1977918	1351813
17428_8#165	75	49	26	1	725551	1.884615	0.038462	1981924	1313766
17175_5#33	26	0	26	0	576265	0.000000	0.000000	1991950	1461624
17175_4#84	188	162	26	8	869009	6.230769	0.307692	1901659	1109071
17966_5#82	388	340	48	13	633534	7.083333	0.270833	1962546	1443977
15995_2#174	0	0	0	0	803739	0.000000	0.000000	2034434	1241331
15995_2#98	1178	1142	36	17	867897	31.722221	0.472222	1906082	1186252
17175_5#64	9	0	9	0	677733	0.000000	0.000000	1975934	1349879
14566_5#2	435	411	24	7	901048	17.125000	0.291667	1905678	1093580
12290_3#82	21	0	21	0	581882	0.000000	0.000000	1979331	1457006
14520_5#89	2	0	2	0	723563	0.000000	0.000000	1983797	1313790
15841_2#60	1	0	1	0	773580	0.000000	0.000000	1925377	1202585
17150_4#45	44	7	37	1	677732	0.189189	0.027027	1980009	1353031
14555_3#31	27	6	21	1	576370	0.285714	0.047619	1997354	1465060
17794_7#137	3	0	3	0	684752	0.000000	0.000000	1974858	1347146
14566_6#92	51	0	51	0	677769	0.000000	0.000000	1980600	1353477
17175_4#23	50	0	50	0	773580	0.000000	0.000000	1916279	1195417
15378_2#78	13	0	13	0	581882	0.000000	0.000000	1978319	1455549
17150_5#22	23	7	16	1	845921	0.437500	0.062500	1915218	1122333
15995_1#99	0	0	0	0	655327	0.000000	0.000000	1987319	1383877
17175_4#46	21	5	16	1	742112	0.312500	0.062500	1934880	1252782
9789_5#89	7	0	7	0	587389	0.000000	0.000000	1976339	1448733
17138_4#64	845	819	26	14	750371	31.500000	0.538462	1974321	1348303
17059_7#31	213	193	20	7	793157	9.650000	0.350000	1913049	1192952
15378_4#87	0	0	0	0	990766	0.000000	0.000000	2007286	1071268
17966_5#61	0	0	0	0	588982	0.000000	0.000000	1963423	1439216
17175_4#35	0	0	0	0	776341	0.000000	0.000000	1918196	1195305
15995_2#190	0	0	0	0	714748	0.000000	0.000000	1911069	1251342
15874_1#49	83	49	34	4	748006	1.441176	0.117647	1929593	1235555
15841_3#27	0	0	0	0	1087738	0.000000	0.000000	1938014	933827
15995_2#69	443	374	69	13	772902	5.420290	0.188406	1929226	1241672
15841_3#89	15	0	15	0	708632	0.000000	0.000000	1949524	1292465
14936_5#20	27	5	22	1	581882	0.227273	0.045455	1975701	1457181
17150_4#7	22	0	22	0	576265	0.000000	0.000000	1996634	1465224
17794_8#102	2	0	2	0	727976	0.000000	0.000000	1973300	1302257
13415_5#16	3668	3303	365	47	794458	9.049315	0.128767	1946133	1623548
15841_2#7	999	958	41	16	746022	23.365854	0.390244	1954170	1351337
15995_1#184	4	0	4	0	869572	0.000000	0.000000	1899878	1089492
13470_1#15	1486	1402	84	28	596057	16.690475	0.333333	2006521	1631168
17428_8#142	4	0	4	0	727976	0.000000	0.000000	1968080	1298877
17794_8#11	7	0	7	0	684752	0.000000	0.000000	1972018	1345596
17175_4#74	105	66	39	6	800985	1.692308	0.153846	1943033	1219816
15531_5#89	481	449	32	8	763980	14.031250	0.250000	1992719	1315432
15841_5#21	360	346	14	6	821875	24.714285	0.428571	1925303	1202640
17059_7#87	12	0	12	0	677727	0.000000	0.000000	1974843	1349487
15995_1#175	45	0	45	0	708632	0.000000	0.000000	1941011	1288303
15531_5#72	15	0	15	0	684752	0.000000	0.000000	1982605	1351991
16399_7#71	1	0	1	0	723563	0.000000	0.000000	1987401	1316030
15841_1#10	28	0	28	0	677787	0.000000	0.000000	1979874	1352621
17175_4#83	143	127	16	2	872214	7.937500	0.125000	1899958	1091300
17138_4#5	4928	4641	287	70	898323	16.170732	0.243902	1958585	1580652
17059_7#29	834	775	59	19	813859	13.135593	0.322034	1927277	1241774
17059_6#48	12	0	12	0	677743	0.000000	0.000000	1975191	1349361
17138_4#77	1846	1754	92	27	674732	19.065218	0.293478	1976958	1601423
15873_2#81	2	0	2	0	684752	0.000000	0.000000	1984728	1352729
14520_5#72	2	0	2	0	684752	0.000000	0.000000	1983477	1352299
14520_4#43	2	0	2	0	684752	0.000000	0.000000	1984641	1352990
15995_2#130	30	0	30	0	677787	0.000000	0.000000	1973205	1348623
17175_4#81	32	4	28	1	768911	0.142857	0.035714	1943218	1249217
15873_1#71	29	0	29	0	773580	0.000000	0.000000	1924680	1201775
14936_5#52	1	0	1	0	581882	0.000000	0.000000	1984514	1459957
17138_3#81	254	216	38	5	875790	5.684210	0.131579	1920969	1127955
14936_5#58	0	0	0	0	581882	0.000000	0.000000	1983140	1458803
14936_4#14	9	0	9	0	742112	0.000000	0.000000	1949883	1262119
17794_8#35	237	224	13	2	723563	17.230770	0.153846	1972644	1307319
14412_1#32	558	512	46	10	657687	11.130435	0.217391	1958228	1414641
15873_5#20	856	852	4	9	901096	213.000000	2.250000	1972929	1216013
14913_5#78	13	0	13	0	810876	0.000000	0.000000	1955275	1214928
17794_8#50	2	0	2	0	741618	0.000000	0.000000	1969945	1288023
17175_5#86	746	718	28	10	655298	25.642857	0.357143	1993010	1462922
13415_8#52	602	517	85	21	694999	6.082353	0.247059	1966832	1415236
15995_2#80	36	0	36	0	804618	0.000000	0.000000	1911633	1159946
17138_4#85	83	45	38	3	682907	1.184211	0.078947	1979362	1352676
17150_4#62	49	5	44	1	678442	0.113636	0.022727	1973063	1347774
17870_7#142	2	0	2	0	581882	0.000000	0.000000	1972090	1450963
17175_4#48	506	468	38	11	667508	12.315789	0.289474	1985671	1456928
15995_2#168	0	0	0	0	714748	0.000000	0.000000	1910339	1250945
17150_5#62	29	0	29	0	677724	0.000000	0.000000	1974352	1349092
15841_4#13	19	0	19	0	869572	0.000000	0.000000	1912655	1099135
15378_3#37	169	153	16	3	771989	9.562500	0.187500	2047123	1291778
17138_4#48	59	10	49	2	709129	0.204082	0.040816	1946754	1292690
15531_5#65	2018	1929	89	24	629977	21.674158	0.269663	1996655	1633832
14520_4#66	1	0	1	0	684752	0.000000	0.000000	1987028	1354976
15995_2#150	5	0	5	0	803739	0.000000	0.000000	2031901	1240054
17059_7#48	170	113	57	3	678629	1.982456	0.052632	1972420	1347461
15873_1#92	331	310	21	2	787787	14.761905	0.095238	1926803	1202960
14412_1#92	270	247	23	6	883924	10.739130	0.260870	1909638	1098142
15995_1#9	0	0	0	0	677786	0.000000	0.000000	1975071	1349909
18456_1#167	52	18	34	3	746488	0.529412	0.088235	2045117	1308305
16399_6#3	0	0	0	0	684752	0.000000	0.000000	1986686	1354181
15995_1#126	170	121	49	6	757595	2.469388	0.122449	1917945	1227021
17059_7#14	603	585	18	4	783044	32.500000	0.222222	1934262	1251791
16399_7#79	4	0	4	0	684752	0.000000	0.000000	1986314	1353701
17870_7#42	1365	1289	76	12	877188	16.960526	0.157895	2024966	1293505
15873_1#39	2	0	2	0	902551	0.000000	0.000000	1920492	1082947
17794_8#33	8	0	8	0	685156	0.000000	0.000000	1971851	1344943
15995_2#9	0	0	0	0	773580	0.000000	0.000000	1911594	1191669
9789_2#36	22	0	22	0	581882	0.000000	0.000000	1986893	1461592
17175_7#41	445	417	28	8	815517	14.892858	0.285714	1915233	1164206
15531_2#43	16	0	16	0	746432	0.000000	0.000000	2044559	1307789
14566_5#22	1594	1482	112	26	804014	13.232142	0.232143	1944595	1407602
15874_1#86	1245	1215	30	8	943833	40.500000	0.266667	1921171	1198803
17175_5#2	617	570	47	9	659296	12.127660	0.191489	1948631	1391822
17138_4#84	815	775	40	7	846391	19.375000	0.175000	1943765	1249770
17175_4#41	0	0	0	0	708632	0.000000	0.000000	1942880	1289229
14913_6#95	273	239	34	2	777000	7.029412	0.058824	1922229	1200154
17150_4#4	1	0	1	0	810876	0.000000	0.000000	1945258	1209936
15841_3#66	32	5	27	1	708632	0.185185	0.037037	1948294	1291980
15841_2#38	2827	2668	159	38	753741	16.779875	0.238994	1967947	1536248
17175_4#91	0	0	0	0	810876	0.000000	0.000000	1943625	1209719
14913_3#81	39	0	39	0	677769	0.000000	0.000000	1985081	1356331
15378_3#82	18	0	18	0	581882	0.000000	0.000000	1984915	1464258
14520_4#93	1	0	1	0	684752	0.000000	0.000000	1985439	1353267
17059_8#91	55	45	10	2	875602	4.500000	0.200000	1901396	1090861
17138_4#6	0	0	0	0	855561	0.000000	0.000000	1944172	1173242
15873_5#83	1	0	1	0	684752	0.000000	0.000000	1986059	1354035
15995_1#136	19	0	19	0	773580	0.000000	0.000000	1913607	1193201
17175_4#27	1135	1094	41	11	875990	26.682926	0.268293	1934771	1244460
15841_5#73	23	8	15	1	658284	0.533333	0.066667	1991538	1386110
15841_2#89	0	0	0	0	677769	0.000000	0.000000	1977788	1349917
15531_2#61	0	0	0	0	990766	0.000000	0.000000	2003891	1069683
17794_8#30	3	0	3	0	684752	0.000000	0.000000	1972699	1346089
9789_5#59	0	0	0	0	587340	0.000000	0.000000	1974947	1447922
15841_4#54	5	0	5	0	655327	0.000000	0.000000	1995567	1389767
14913_6#58	543	516	27	9	878251	19.111111	0.333333	1918700	1126177
17138_4#12	130	110	20	4	783801	5.500000	0.200000	1920432	1198798
15995_1#144	3	0	3	0	869572	0.000000	0.000000	1900258	1090138
16453_2#43	4	0	4	0	723563	0.000000	0.000000	1974884	1308420
12837_4#1	111	31	80	1	611551	0.387500	0.012500	1950781	1395028
17175_5#57	43	8	35	1	773580	0.228571	0.028571	1914635	1194559
13415_4#86	376	356	20	4	624507	17.799999	0.200000	1954409	1396180
17175_4#19	6	0	6	0	773580	0.000000	0.000000	1916704	1196421
17794_7#101	0	0	0	0	684752	0.000000	0.000000	1973291	1346411
16399_7#61	4	0	4	0	685156	0.000000	0.000000	1986001	1353270
17059_6#32	19	0	19	0	677740	0.000000	0.000000	1977229	1351436
19183_3#90	29	5	24	1	684752	0.208333	0.041667	1973945	1347006
15531_4#4	2	0	2	0	766408	0.000000	0.000000	2041959	1291453
17059_8#4	1	0	1	0	576265	0.000000	0.000000	1988538	1459521
14520_5#66	1	0	1	0	684752	0.000000	0.000000	1984609	1353534
15531_2#15	4	0	4	0	587340	0.000000	0.000000	1974764	1448067
15378_4#42	229	219	10	6	888836	21.900000	0.600000	2020156	1199583
15378_3#1	1	0	1	0	870178	0.000000	0.000000	2015565	1182711
14555_4#36	11	0	11	0	869572	0.000000	0.000000	1892150	1083302
12290_3#75	0	0	0	0	581882	0.000000	0.000000	1978510	1455719
14520_5#49	0	0	0	0	823264	0.000000	0.000000	1983873	1217109
9716_7#20	3	0	3	0	581882	0.000000	0.000000	1982611	1457103
17138_4#82	12	0	12	0	869572	0.000000	0.000000	1907428	1095429
15995_1#189	2	0	2	0	869572	0.000000	0.000000	1902436	1091470
15531_2#30	0	0	0	0	990766	0.000000	0.000000	2004075	1069621
15995_1#1	0	0	0	0	677787	0.000000	0.000000	1974900	1349939
17870_8#4	19	0	19	0	688027	0.000000	0.000000	1933120	1321234
17059_7#2	29	4	25	1	773684	0.160000	0.040000	1916134	1196805
17966_5#62	1	0	1	0	588982	0.000000	0.000000	1964068	1439676
17794_8#4	606	576	30	6	807797	19.200001	0.200000	1971239	1301531
15531_5#82	302	273	29	10	743435	9.413794	0.344828	1981485	1318973
17175_4#55	38	0	38	0	677730	0.000000	0.000000	1975077	1350384
17175_4#71	3	0	3	0	810876	0.000000	0.000000	1940573	1207519
14723_6#10	2656	2547	109	33	765095	23.366972	0.302752	1995865	1687490
17059_7#52	8	0	8	0	742112	0.000000	0.000000	1935290	1252513
17059_6#35	3	0	3	0	714748	0.000000	0.000000	1916094	1255246
17175_4#60	552	530	22	3	928752	24.090910	0.136364	1902281	1091549
14555_4#66	490	428	62	3	698285	6.903226	0.048387	1934768	1340442
9789_3#65	7	7	0	1	870178	0.000000	0.000000	2016467	1183139
14555_4#24	39	5	34	1	655388	0.147059	0.029412	1992856	1387992
9789_5#14	0	0	0	0	581882	0.000000	0.000000	1981174	1457971
15841_4#3	1	0	1	0	677767	0.000000	0.000000	1979105	1351083
17059_7#69	39	0	39	0	677724	0.000000	0.000000	1977748	1351940
14555_4#45	6	0	6	0	742112	0.000000	0.000000	1936982	1253841
15995_2#164	1013	951	62	12	842983	15.338710	0.193548	1919489	1224972
12837_3#42	21	5	16	1	655327	0.312500	0.062500	1996448	1390457
17794_8#74	1	0	1	0	723563	0.000000	0.000000	1973174	1307535
15841_3#8	190	169	21	2	576346	8.047619	0.095238	1996988	1465441
17175_4#43	0	0	0	0	776341	0.000000	0.000000	1917118	1194297
15731_8#81	25	14	11	2	870033	1.272727	0.181818	1907050	1094027
14520_5#24	0	0	0	0	684752	0.000000	0.000000	1984748	1353126
15995_2#34	1306	1276	30	12	720149	42.533333	0.400000	1970101	1443102
18456_1#13	5	0	5	0	820116	0.000000	0.000000	1954724	1221720
17175_5#4	439	405	34	9	817719	11.911765	0.264706	1919538	1197260
18456_1#111	1677	1615	62	17	844276	26.048388	0.274194	2085879	1396024
14913_2#20	40	0	40	0	677787	0.000000	0.000000	1981254	1353007
19183_3#104	1	0	1	0	741618	0.000000	0.000000	1971914	1289258
15841_2#52	0	0	0	0	773580	0.000000	0.000000	1925631	1202654
14913_7#24	28	8	20	1	693888	0.400000	0.050000	1985596	1341750
19183_3#105	11	0	11	0	695896	0.000000	0.000000	1974420	1336667
15841_4#70	2	0	2	0	869572	0.000000	0.000000	1910070	1097518
14520_4#9	14	10	4	2	684791	2.500000	0.500000	1998908	1361463
17059_6#88	144	117	27	3	875126	4.333333	0.111111	1906277	1093524
17870_8#131	211	198	13	2	605273	15.230769	0.153846	1969636	1443080
18456_1#24	0	0	0	0	820116	0.000000	0.000000	1955532	1221858
17059_8#53	0	0	0	0	776341	0.000000	0.000000	1914854	1192423
19341_2#31	230	196	34	3	608373	5.764706	0.088235	1971329	1449321
14913_3#80	26	0	26	0	869572	0.000000	0.000000	1913680	1099474
14520_4#95	1	0	1	0	723563	0.000000	0.000000	1984696	1314426
17175_4#33	2	0	2	0	708632	0.000000	0.000000	1943442	1289752
14520_4#21	2	0	2	0	723563	0.000000	0.000000	1986068	1315016
16399_5#62	1	0	1	0	684752	0.000000	0.000000	1983302	1352310
15995_2#3	0	0	0	0	773580	0.000000	0.000000	1912697	1192560
15873_4#76	0	0	0	0	684752	0.000000	0.000000	1983577	1352465
15873_5#78	2	0	2	0	684752	0.000000	0.000000	1982678	1351650
15378_3#32	0	0	0	0	581882	0.000000	0.000000	1981569	1457760
15995_1#119	0	0	0	0	1087738	0.000000	0.000000	1927094	928440
15731_8#87	3	0	3	0	677787	0.000000	0.000000	1982666	1355057
15874_1#82	57	26	31	2	729134	0.838710	0.064516	1947782	1270812
N7	1	0	1	0	748006	0.000000	0.000000	1931305	1234893
N6	124	112	12	2	748006	9.333333	0.166667	1939765	1269698
N17	2	0	2	0	869572	0.000000	0.000000	1918027	1103386
N20	32	25	7	1	869572	3.571429	0.142857	1918149	1103797
N19	0	0	0	0	869572	0.000000	0.000000	1921076	1105783
N23	0	0	0	0	869572	0.000000	0.000000	1911218	1098450
N22	0	0	0	0	869572	0.000000	0.000000	1918181	1103876
N21	6	0	6	0	869572	0.000000	0.000000	1920225	1105687
N18	0	0	0	0	869572	0.000000	0.000000	1925068	1109178
N16	2	0	2	0	869572	0.000000	0.000000	1926668	1110398
N26	0	0	0	0	869572	0.000000	0.000000	1905407	1093998
N25	0	0	0	0	869572	0.000000	0.000000	1906610	1094814
N24	19	0	19	0	869572	0.000000	0.000000	1912052	1099141
N15	0	0	0	0	869572	0.000000	0.000000	1926879	1110558
N14	0	0	0	0	869572	0.000000	0.000000	1927053	1110714
N13	332	310	22	6	869572	14.090909	0.272727	1927291	1133220
N12	33	31	2	2	844954	15.500000	1.000000	1939832	1142958
N29	1275	1225	50	24	902551	24.500000	0.480000	1924665	1128812
N28	3	0	3	0	845921	0.000000	0.000000	1931098	1134593
N27	75	48	27	5	845921	1.777778	0.185185	1932265	1136978
N11	1	0	1	0	844503	0.000000	0.000000	1941696	1143969
N10	757	750	7	15	844503	107.142860	2.142857	1942187	1215146
N9	5	0	5	0	773580	0.000000	0.000000	1943790	1216527
N37	0	0	0	0	773580	0.000000	0.000000	1930395	1206804
N38	162	131	31	2	773580	4.225806	0.064516	1916331	1195477
N36	0	0	0	0	773580	0.000000	0.000000	1931456	1207540
N42	0	0	0	0	773580	0.000000	0.000000	1929288	1205298
N41	0	0	0	0	773580	0.000000	0.000000	1932052	1207738
N40	5	0	5	0	773580	0.000000	0.000000	1932982	1208435
N39	14	0	14	0	773580	0.000000	0.000000	1934602	1209599
N35	0	0	0	0	773580	0.000000	0.000000	1939007	1213458
N43	1	0	1	0	773580	0.000000	0.000000	1928351	1204262
N34	1	0	1	0	773580	0.000000	0.000000	1940284	1214303
N33	16	0	16	0	773580	0.000000	0.000000	1940491	1214432
N46	2	0	2	0	773580	0.000000	0.000000	1923543	1200952
N45	2	0	2	0	773580	0.000000	0.000000	1932543	1207253
N48	467	461	6	6	804618	76.833336	1.000000	1925991	1202891
N47	1	0	1	0	773580	0.000000	0.000000	1934192	1209388
N44	5	0	5	0	773580	0.000000	0.000000	1938811	1212081
N32	4	0	4	0	773580	0.000000	0.000000	1944818	1216987
N53	0	0	0	0	776341	0.000000	0.000000	1921764	1197861
N52	53	18	35	2	776341	0.514286	0.057143	1924276	1201641
N51	6	0	6	0	773580	0.000000	0.000000	1925768	1203000
N55	21	0	21	0	773580	0.000000	0.000000	1932871	1208824
N54	0	0	0	0	773580	0.000000	0.000000	1933734	1209424
N50	3	0	3	0	773580	0.000000	0.000000	1936005	1211053
N49	4	0	4	0	773580	0.000000	0.000000	1937090	1211804
N31	0	0	0	0	773580	0.000000	0.000000	1946116	1218067
N30	12	0	12	0	773580	0.000000	0.000000	1946666	1218567
N8	456	422	34	7	773580	12.411765	0.205882	1950920	1275901
N5	2315	2183	132	27	719404	16.537878	0.204545	1964402	1547560
N60	0	0	0	0	714748	0.000000	0.000000	1914205	1253794
N59	792	677	115	21	722202	5.886957	0.182609	1924001	1339823
N58	352	337	15	8	635967	22.466667	0.533333	1962754	1417403
N57	37	22	15	3	578449	1.466667	0.200000	1968971	1425932
N61	113	74	39	4	593458	1.897436	0.102564	1967634	1424939
N56	899	806	93	18	575573	8.666667	0.193548	1974235	1559581
N4	473	342	131	15	441383	2.610687	0.114504	1996896	1598518
N3	351	289	62	10	414785	4.661290	0.161290	2000319	1685413
N2	1974	1707	267	33	331017	6.393259	0.123596	2022508	2022508
N64	900	853	47	11	688027	18.148935	0.234043	1959471	1398256
N65	166	146	20	6	648501	7.300000	0.300000	1964340	1401043
N63	286	217	69	9	605470	3.144928	0.130435	1969540	1421518
N68	894	867	27	10	755657	32.111111	0.370370	1944595	1377981
N72	4	0	4	0	742112	0.000000	0.000000	1951181	1263044
N74	0	0	0	0	742112	0.000000	0.000000	1941138	1256734
N73	6	0	6	0	742112	0.000000	0.000000	1945573	1258726
N71	719	689	30	6	742112	22.966667	0.200000	1957708	1299939
N70	6	0	6	0	708632	0.000000	0.000000	1964394	1302232
N78	146	136	10	2	729134	13.600000	0.200000	1951918	1293187
N77	0	0	0	0	708632	0.000000	0.000000	1959389	1299743
N76	4	0	4	0	708632	0.000000	0.000000	1961247	1301228
N84	1011	978	33	12	855561	29.636364	0.363636	1946743	1251020
N83	27	5	22	1	769107	0.227273	0.045455	1954883	1256634
N82	1	0	1	0	768907	0.000000	0.000000	1958076	1258650
N86	6	0	6	0	768907	0.000000	0.000000	1958640	1257723
N89	0	0	0	0	810876	0.000000	0.000000	1948514	1211718
N88	25	0	25	0	810876	0.000000	0.000000	1951128	1213360
N87	854	828	26	12	810876	31.846153	0.461538	1962041	1260475
N85	16	13	3	1	768907	4.333333	0.333333	1965867	1262884
N81	0	0	0	0	768907	0.000000	0.000000	1968512	1264431
N80	720	629	91	15	768907	6.912088	0.164835	1969512	1306796
N92	25	0	25	0	708632	0.000000	0.000000	1947752	1292276
N91	16	0	16	0	708632	0.000000	0.000000	1957356	1297738
N90	3	0	3	0	708632	0.000000	0.000000	1958696	1298657
N79	3	0	3	0	708632	0.000000	0.000000	1971844	1308773
N75	0	0	0	0	708632	0.000000	0.000000	1972489	1309249
N69	1305	1221	84	17	708632	14.535714	0.202381	1974617	1400665
N67	54	40	14	2	611115	2.857143	0.142857	1978898	1411562
N95	7	0	7	0	714996	0.000000	0.000000	1958139	1295898
N98	734	701	33	9	1087738	21.242424	0.272727	1938811	1015333
N97	2333	2288	45	23	1002282	50.844444	0.511111	1946112	1223889
N96	904	785	119	22	786522	6.596639	0.184874	1968047	1304021
N94	715	698	17	6	714996	41.058823	0.352941	1973830	1410948
N93	20	10	10	1	602176	1.000000	0.100000	1980014	1414488
N66	164	114	50	9	602176	2.280000	0.180000	1989828	1435763
N62	3661	3526	135	61	586501	26.118519	0.451852	1994355	1994355
N104	101	71	30	3	746432	2.366667	0.100000	2048802	1314999
N108	1	0	1	0	990766	0.000000	0.000000	2006118	1070742
N107	1432	1415	17	19	990766	83.235291	1.117647	2008743	1197982
N106	283	240	43	6	852513	5.581395	0.139535	2039084	1206321
N105	992	953	39	11	849998	24.435898	0.282051	2044214	1309191
N103	21	12	9	2	742792	1.333333	0.222222	2056489	1322853
N110	808	760	48	8	803739	15.833333	0.166667	2036518	1300107
N109	20	12	8	1	746277	1.500000	0.125000	2050966	1317737
N102	0	0	0	0	741200	0.000000	0.000000	2058692	1324245
N113	31	0	31	0	766408	0.000000	0.000000	2042954	1292076
N112	297	255	42	10	766408	6.071429	0.238095	2050661	1317936
N115	9	0	9	0	870178	0.000000	0.000000	2018744	1184624
N114	1306	1264	42	25	870178	30.095238	0.595238	2020382	1306049
N111	15	5	10	1	741200	0.500000	0.100000	2055082	1321421
N101	583	550	33	8	741200	16.666666	0.242424	2060804	1376110
N100	2903	2787	116	45	690618	24.025862	0.387931	2086550	1787756
N124	32	6	26	1	581882	0.230769	0.038462	1986548	1461454
N125	27	11	16	1	581882	0.687500	0.062500	1986224	1461014
N123	4	0	4	0	581882	0.000000	0.000000	1991380	1464709
N128	0	0	0	0	581882	0.000000	0.000000	1985665	1460570
N127	35	16	19	1	581882	0.842105	0.052632	1989760	1461999
N126	0	0	0	0	581882	0.000000	0.000000	1996440	1467026
N122	58	47	11	3	581882	4.272727	0.272727	1999259	1468955
N133	84	63	21	3	588982	3.000000	0.142857	1966984	1448579
N135	198	174	24	7	587389	7.250000	0.291667	1983314	1458294
N134	0	0	0	0	581882	0.000000	0.000000	1986496	1460323
N132	7	0	7	0	581882	0.000000	0.000000	1987244	1460966
N131	1	0	1	0	581882	0.000000	0.000000	1989145	1462540
N137	151	124	27	3	587340	4.592593	0.111111	1978652	1454616
N136	2	0	2	0	581882	0.000000	0.000000	1989372	1463411
N130	2	0	2	0	581882	0.000000	0.000000	1993857	1465808
N129	0	0	0	0	581882	0.000000	0.000000	1993915	1465839
N121	0	0	0	0	581882	0.000000	0.000000	2001693	1470199
N120	0	0	0	0	581882	0.000000	0.000000	2001979	1470457
N119	1499	1437	62	17	581882	23.177420	0.274194	2002456	1587536
N142	33	0	33	0	655327	0.000000	0.000000	1996794	1390610
N141	0	0	0	0	655327	0.000000	0.000000	2000235	1393141
N140	3	0	3	0	655327	0.000000	0.000000	2001007	1393634
N139	1053	957	96	18	655327	9.968750	0.187500	2002178	1497376
N143	395	357	38	12	620313	9.394737	0.315789	1975292	1498751
N138	655	599	56	11	543918	10.696428	0.196429	2009692	1586885
N118	559	534	25	11	460405	21.360001	0.440000	2021431	1677901
N148	3	0	3	0	677769	0.000000	0.000000	1989613	1359910
N147	0	0	0	0	677769	0.000000	0.000000	1991141	1361041
N156	3	0	3	0	677769	0.000000	0.000000	1981097	1352316
N155	38	9	29	1	677769	0.310345	0.034483	1981652	1352721
N154	14	0	14	0	677769	0.000000	0.000000	1990008	1359986
N159	2	0	2	0	677726	0.000000	0.000000	1981172	1354388
N158	1	0	1	0	677727	0.000000	0.000000	1982511	1355318
N157	1	0	1	0	677731	0.000000	0.000000	1985173	1357259
N153	0	0	0	0	677769	0.000000	0.000000	1992939	1362339
N152	0	0	0	0	677769	0.000000	0.000000	1995100	1364437
N151	0	0	0	0	677769	0.000000	0.000000	1995367	1364691
N150	2	0	2	0	677769	0.000000	0.000000	1995693	1364947
N161	4	0	4	0	677787	0.000000	0.000000	1982851	1355230
N167	0	0	0	0	677787	0.000000	0.000000	1983258	1355512
N166	13	0	13	0	677787	0.000000	0.000000	1983716	1355898
N165	14	0	14	0	677787	0.000000	0.000000	1987992	1358753
N164	2	0	2	0	677787	0.000000	0.000000	1989725	1360104
N168	21	0	21	0	677743	0.000000	0.000000	1979073	1352557
N163	2	0	2	0	677787	0.000000	0.000000	1991176	1361207
N171	44	38	6	1	692937	6.333333	0.166667	1988947	1359337
N172	4	0	4	0	677787	0.000000	0.000000	1983958	1356416
N170	4	0	4	0	677787	0.000000	0.000000	1990409	1360516
N169	0	0	0	0	677787	0.000000	0.000000	1991534	1361263
N162	6	0	6	0	677787	0.000000	0.000000	1993336	1362568
N160	33	10	23	2	677787	0.434783	0.086957	1993655	1362685
N149	1	0	1	0	677769	0.000000	0.000000	1997604	1366112
N146	2444	2331	113	36	677769	20.628319	0.318584	1998174	1634078
N145	117	98	19	7	389070	5.157895	0.368421	2023404	1675462
N177	10	0	10	0	576265	0.000000	0.000000	2001388	1467260
N183	1	0	1	0	576265	0.000000	0.000000	1999951	1467226
N182	0	0	0	0	576265	0.000000	0.000000	2005397	1470063
N184	51	25	26	2	576265	0.961538	0.076923	1993814	1462839
N181	7	0	7	0	576265	0.000000	0.000000	2006844	1471117
N180	0	0	0	0	576265	0.000000	0.000000	2007333	1471574
N179	0	0	0	0	576265	0.000000	0.000000	2007835	1471852
N178	1	0	1	0	576265	0.000000	0.000000	2011734	1475013
N176	62	57	5	2	576265	11.400000	0.400000	2013839	1476929
N175	2027	1894	133	20	575337	14.240602	0.150376	2014691	1635352
N174	0	0	0	0	414231	0.000000	0.000000	2037665	1641178
N173	107	86	21	6	414231	4.095238	0.285714	2041331	1687955
N144	61	36	25	2	369763	1.440000	0.080000	2044312	1695284
N117	218	124	94	8	364377	1.319149	0.085106	2047633	1725897
N188	2600	2483	117	38	820116	21.222221	0.324786	1959132	1545066
N187	309	272	37	14	477963	7.351351	0.378378	2007534	1659654
N193	6	6	0	1	727267	0.000000	0.000000	1999597	1323053
N194	11	8	3	1	726803	2.666667	0.333333	2000401	1323453
N192	0	0	0	0	725551	0.000000	0.000000	2004473	1326160
N191	1641	1571	70	24	725551	22.442858	0.342857	2005345	1459738
N198	0	0	0	0	823264	0.000000	0.000000	1985284	1217855
N197	0	0	0	0	823264	0.000000	0.000000	1987988	1219333
N196	1496	1441	55	13	823264	26.200001	0.236364	1989261	1356335
N200	7	0	7	0	684752	0.000000	0.000000	1988645	1355971
N204	0	0	0	0	723563	0.000000	0.000000	1977581	1310766
N208	0	0	0	0	723563	0.000000	0.000000	1987906	1316286
N207	0	0	0	0	723563	0.000000	0.000000	1988811	1316946
N206	18	14	4	2	723563	3.500000	0.500000	1990174	1317728
N205	3	0	3	0	723563	0.000000	0.000000	1991502	1318453
N203	235	227	8	2	723563	28.375000	0.250000	1992842	1347383
N202	145	128	17	4	695896	7.529412	0.235294	1992982	1358632
N212	559	536	23	5	741618	23.304348	0.217391	1974703	1347808
N215	0	0	0	0	685156	0.000000	0.000000	1975455	1347314
N214	35	9	26	1	685156	0.346154	0.038462	1988555	1355336
N230	0	0	0	0	684752	0.000000	0.000000	1987955	1354909
N229	1	0	1	0	684752	0.000000	0.000000	1989234	1355656
N228	0	0	0	0	684752	0.000000	0.000000	1989458	1355780
N227	0	0	0	0	684752	0.000000	0.000000	1989745	1355963
N226	0	0	0	0	684752	0.000000	0.000000	1990094	1356233
N225	0	0	0	0	684752	0.000000	0.000000	1990265	1356284
N224	4	0	4	0	684752	0.000000	0.000000	1990802	1356658
N223	0	0	0	0	684752	0.000000	0.000000	1991373	1356911
N231	1	0	1	0	684752	0.000000	0.000000	1987553	1354613
N222	0	0	0	0	684752	0.000000	0.000000	1991818	1357182
N221	0	0	0	0	684752	0.000000	0.000000	1991998	1357261
N232	6	0	6	0	684752	0.000000	0.000000	1988143	1354978
N220	0	0	0	0	684752	0.000000	0.000000	1992596	1357638
N219	5	0	5	0	684752	0.000000	0.000000	2005982	1365906
N218	0	0	0	0	684752	0.000000	0.000000	2006779	1366351
N217	0	0	0	0	684752	0.000000	0.000000	2006891	1366413
N216	28	8	20	1	684752	0.400000	0.050000	2006962	1366464
N213	0	0	0	0	684752	0.000000	0.000000	2007199	1366629
N211	0	0	0	0	684752	0.000000	0.000000	2007463	1366759
N210	3	0	3	0	684752	0.000000	0.000000	2008851	1368141
N235	686	674	12	10	727976	56.166668	0.833333	1974548	1346290
N234	1	0	1	0	684752	0.000000	0.000000	1979747	1350619
N238	14	0	14	0	684752	0.000000	0.000000	1976091	1347964
N237	0	0	0	0	684752	0.000000	0.000000	1978541	1349640
N236	5	0	5	0	684752	0.000000	0.000000	1987167	1354454
N233	0	0	0	0	684752	0.000000	0.000000	1990157	1356578
N209	0	0	0	0	684752	0.000000	0.000000	2009528	1368353
N201	2	0	2	0	684752	0.000000	0.000000	2010274	1368967
N199	113	93	20	4	684752	4.650000	0.200000	2010333	1369690
N195	982	937	45	18	684079	20.822222	0.400000	2011626	1471951
N190	1541	1408	133	21	582967	10.586466	0.157895	2027274	1645628
N189	161	130	31	5	407636	4.193548	0.161290	2031696	1666818
N186	221	172	49	7	388276	3.510204	0.142857	2036410	1716464
N185	67	45	22	4	342499	2.045455	0.181818	2037944	1719856
N116	189	120	69	8	336500	1.739130	0.115942	2049995	1763924
N99	1332	1263	69	22	299148	18.304348	0.318841	2087539	2087539
N1	0	0	0	0	0	0.000000	0.000000	2088125	2088125
