Node	Total SNPs	Num of SNPs inside recombinations	Num of SNPs outside recombinations	Num of Recombination Blocks	Bases in Recombinations	r/m	rho/theta	Genome Length	Bases in Clonal Frame
13353_7#14	118	65	53	2	28132	1.226415	0.037736	1930331	1930331
19084_7#81	214	177	37	5	1046936	4.783784	0.135135	2008945	1011079
15608_3#45	8	0	8	0	988626	0.000000	0.000000	2019892	1085079
14555_4#18	33	14	19	2	988112	0.736842	0.105263	1983651	1053375
19341_2#75	3	0	3	0	1129808	0.000000	0.000000	1991786	943103
15608_3#50	138	120	18	1	984825	6.666667	0.055556	2020358	1086617
22841_3#15	170	157	13	1	986148	12.076923	0.076923	2022127	1090444
11679_1#64	0	0	0	0	983464	0.000000	0.000000	1984455	1061508
13415_7#85	937	896	41	19	996059	21.853659	0.463415	2022220	1100532
19084_7#103	25	0	25	0	959733	0.000000	0.000000	1986963	1087266
11511_7#25	178	140	38	6	982129	3.684211	0.157895	2065817	1110496
13415_7#43	102	84	18	4	968432	4.666667	0.222222	2021394	1095017
11679_1#95	802	774	28	12	1024002	27.642857	0.428571	1976045	1080716
14673_2#10	372	361	11	1	982646	32.818180	0.090909	2103690	1133606
13470_1#85	682	652	30	6	1019382	21.733334	0.200000	2021079	1091286
11826_1#52	50	35	15	1	979534	2.333333	0.066667	2020812	1092849
11511_7#74	1	0	1	0	984069	0.000000	0.000000	2088069	1131007
15608_3#41	169	119	50	1	986545	2.380000	0.020000	2040716	1104259
11893_8#1	13	0	13	0	984069	0.000000	0.000000	2074744	1129621
15277_1#18	125	79	46	5	968456	1.717391	0.108696	2093518	1141484
21127_2#79	650	536	114	8	1179299	4.701755	0.070175	1915491	893066
19341_2#88	7	0	7	0	977782	0.000000	0.000000	1998735	1090532
11822_1#51	8	0	8	0	983647	0.000000	0.000000	2078155	1130653
15608_3#51	1	0	1	0	985205	0.000000	0.000000	2033666	1095119
12162_1#10	11	0	11	0	978731	0.000000	0.000000	2019318	1089321
15682_1#79	257	217	40	1	901872	5.425000	0.025000	1989944	1189694
19084_8#16	22	0	22	0	1080276	0.000000	0.000000	1947401	966856
14410_8#4	422	405	17	7	987211	23.823530	0.411765	2010752	1093709
11511_7#32	8	0	8	0	967868	0.000000	0.000000	2103717	1144981
18090_2#41	13	0	13	0	977801	0.000000	0.000000	2001016	1091796
12837_3#17	4	0	4	0	972072	0.000000	0.000000	2021842	1092168
11511_8#89	23	12	11	1	1080276	1.090909	0.090909	1952212	970135
13415_8#28	15	0	15	0	982694	0.000000	0.000000	2024873	1087027
13415_5#77	16	11	5	1	982694	2.200000	0.200000	2023928	1086275
11791_1#11	103	93	10	1	982646	9.300000	0.100000	2110093	1135091
19084_8#3	41	22	19	1	1029251	1.157895	0.052632	1973826	1036194
14566_5#30	19	0	19	0	971668	0.000000	0.000000	2016034	1089735
21127_2#51	395	288	107	13	1162664	2.691589	0.121495	1909545	891923
12162_1#70	317	297	20	2	979010	14.850000	0.100000	2035253	1094747
14673_1#93	146	135	11	1	984069	12.272727	0.090909	2099678	1133363
13414_8#49	70	54	16	2	982694	3.375000	0.125000	2022039	1085589
11657_1#72	672	556	116	16	888054	4.793103	0.137931	1991084	1229577
12162_1#55	109	83	26	1	978736	3.192308	0.038462	2039393	1093650
19341_2#77	7	0	7	0	1129808	0.000000	0.000000	1992665	943426
12291_3#36	560	522	38	12	971372	13.736842	0.315789	2020203	1101776
15608_3#53	54	48	6	1	985256	8.000000	0.166667	2031193	1093077
13414_4#12	94	83	11	2	984074	7.545455	0.181818	2097306	1131242
14410_8#24	128	109	19	1	978907	5.736842	0.052632	2041325	1093540
18090_2#157	5	0	5	0	1099239	0.000000	0.000000	1991810	974132
11657_2#1	43	8	35	1	979606	0.228571	0.028571	2008751	1092121
13415_4#3	154	133	21	5	988513	6.333333	0.238095	2019341	1091648
15608_4#18	37	30	7	1	990052	4.285714	0.142857	2035552	1090696
19341_2#78	13	0	13	0	977821	0.000000	0.000000	1998440	1090048
11679_1#89	373	350	23	2	972631	15.217391	0.086957	1997646	1090874
15841_2#22	756	722	34	15	1027359	21.235294	0.441176	2015712	1087904
15608_2#35	77	44	33	3	965428	1.333333	0.090909	2094808	1144461
13415_4#39	181	161	20	3	980703	8.050000	0.150000	2042735	1097086
15608_3#71	238	226	12	1	990100	18.833334	0.083333	2051345	1104189
15608_3#83	1	0	1	0	984964	0.000000	0.000000	2026375	1090240
13415_5#84	58	43	15	2	963774	2.866667	0.133333	2021243	1100241
15608_4#23	8	0	8	0	982158	0.000000	0.000000	2022095	1089165
14566_4#42	18	0	18	0	978731	0.000000	0.000000	2020224	1087669
11657_1#75	252	241	11	1	985283	21.909090	0.090909	2084897	1126689
11822_1#48	28	22	6	2	983647	3.666667	0.333333	2096489	1133233
13415_7#12	1	0	1	0	978731	0.000000	0.000000	2019884	1088084
18090_2#148	1	0	1	0	977803	0.000000	0.000000	1996314	1090443
15608_2#41	232	209	23	1	984041	9.086957	0.043478	2029929	1096292
14566_5#78	86	65	21	3	985902	3.095238	0.142857	2018270	1082994
18090_2#177	2	0	2	0	1129808	0.000000	0.000000	1993781	943589
15608_4#24	632	613	19	9	1022628	32.263157	0.473684	2011136	1084596
11511_7#50	580	480	100	6	909636	4.800000	0.060000	2011410	1253104
21127_1#159	147	78	69	1	1102073	1.130435	0.014493	1943660	958499
15608_2#42	93	83	10	6	998398	8.300000	0.600000	2084283	1097056
11822_1#24	132	115	17	2	968386	6.764706	0.117647	2092642	1145273
12291_5#9	19	0	19	0	985443	0.000000	0.000000	2057611	1106835
18090_2#45	5	0	5	0	1129808	0.000000	0.000000	1991786	942571
13414_8#67	9	0	9	0	963774	0.000000	0.000000	2022223	1101245
22841_3#42	11	0	11	0	986889	0.000000	0.000000	2028403	1090959
11822_1#14	11	0	11	0	983647	0.000000	0.000000	2076528	1131204
19084_8#145	158	128	30	2	967877	4.266667	0.066667	2095563	1142755
15682_1#74	70	51	19	2	1129591	2.684211	0.105263	2000793	945989
13415_5#48	212	189	23	5	978514	8.217391	0.217391	2021133	1092045
12837_3#15	0	0	0	0	983974	0.000000	0.000000	2102236	1132874
18090_2#174	19	5	14	1	977902	0.357143	0.071429	1998259	1090300
14555_3#49	178	165	13	4	995841	12.692307	0.307692	2017991	1081557
18090_1#187	5	0	5	0	1129808	0.000000	0.000000	1993059	944010
18090_2#152	1	0	1	0	977814	0.000000	0.000000	2000205	1091540
11826_1#70	35	31	4	2	982646	7.750000	0.500000	2115337	1135065
12299_1#14	104	63	41	4	836039	1.536585	0.097561	1986703	1233314
13415_7#34	28	0	28	0	980869	0.000000	0.000000	2022896	1084187
14566_5#32	14	0	14	0	982694	0.000000	0.000000	2014927	1083515
11658_2#44	0	0	0	0	983464	0.000000	0.000000	1988607	1064519
14566_5#81	15	0	15	0	978731	0.000000	0.000000	2017341	1086527
13415_6#9	1123	1084	39	28	1053122	27.794872	0.717949	2013365	1074069
19084_7#176	35	4	31	1	1043735	0.129032	0.032258	1975855	999557
13710_2#65	293	227	66	1	959389	3.439394	0.015152	2073813	1154425
15682_1#39	24	0	24	0	979474	0.000000	0.000000	2002633	1089955
19341_2#131	25	0	25	0	985420	0.000000	0.000000	2000653	1084003
15608_3#55	1	0	1	0	990085	0.000000	0.000000	2039991	1093366
13415_4#29	112	102	10	2	978907	10.200000	0.200000	2044452	1097195
18090_2#40	462	453	9	5	1143991	50.333332	0.555556	1980303	940433
15608_4#28	7	0	7	0	984902	0.000000	0.000000	2015291	1086592
11511_7#34	81	78	3	2	983647	26.000000	0.666667	2108620	1133400
22841_3#31	3	0	3	0	986108	0.000000	0.000000	2003373	1084104
12837_3#14	0	0	0	0	983974	0.000000	0.000000	2101914	1132561
11511_7#22	16	7	9	1	982646	0.777778	0.111111	2102795	1133998
15682_2#2	86	64	22	2	1154441	2.909091	0.090909	2023408	928228
19084_7#179	157	141	16	2	1036378	8.812500	0.125000	1941525	1014015
14410_8#66	31	8	23	1	982694	0.347826	0.043478	2020979	1084799
21053_8#171	1111	1008	103	21	1002560	9.786407	0.203883	1975785	1146889
13415_4#65	150	131	19	2	971668	6.894737	0.105263	2017007	1091878
18090_2#43	13	0	13	0	977900	0.000000	0.000000	1999912	1090862
13414_8#58	19	0	19	0	982810	0.000000	0.000000	2030009	1085940
14673_2#1	12	0	12	0	984074	0.000000	0.000000	2093499	1132715
19084_7#86	106	83	23	5	974023	3.608696	0.217391	1994316	1088282
15608_2#87	3	0	3	0	984069	0.000000	0.000000	2073991	1129295
12837_5#31	10	0	10	0	978731	0.000000	0.000000	2025558	1090734
14566_6#18	8	0	8	0	978731	0.000000	0.000000	2021710	1089062
11657_2#49	320	304	16	1	983761	19.000000	0.062500	2103836	1132413
15682_2#11	264	236	28	6	1169301	8.428572	0.214286	1997706	923114
19341_2#92	12	0	12	0	977965	0.000000	0.000000	2001082	1091941
14566_4#77	59	49	10	1	978731	4.900000	0.100000	2019659	1088297
15608_4#30	4	0	4	0	990085	0.000000	0.000000	2040901	1093353
19084_8#150	40	30	10	2	982646	3.000000	0.200000	2118357	1137022
22841_3#148	9	0	9	0	986067	0.000000	0.000000	2018776	1087081
13415_5#34	0	0	0	0	978731	0.000000	0.000000	2016631	1086329
15682_1#35	6	0	6	0	979419	0.000000	0.000000	2017021	1094163
15608_3#75	66	60	6	1	990031	10.000000	0.166667	2039513	1093590
13470_1#17	163	157	6	2	982694	26.166666	0.333333	2024040	1086711
22667_8#71	219	179	40	1	979844	4.475000	0.025000	2014049	1091272
11657_1#73	56	43	13	1	983647	3.307692	0.076923	2096970	1132154
15608_4#4	0	0	0	0	982216	0.000000	0.000000	2024010	1090130
14673_4#10	10	0	10	0	982646	0.000000	0.000000	2074186	1130105
15682_2#28	12	0	12	0	979422	0.000000	0.000000	2005474	1090368
14555_3#16	378	364	14	5	1030873	26.000000	0.357143	1999193	1070526
15608_4#15	3	0	3	0	984861	0.000000	0.000000	2028302	1091126
12837_3#65	52	37	15	2	985046	2.466667	0.133333	2113629	1134489
14673_1#92	192	173	19	8	998398	9.105263	0.421053	2090773	1098567
24775_1#63	1748	1215	533	34	811212	2.279550	0.063790	1899040	1362575
15608_3#86	50	0	50	0	979412	0.000000	0.000000	1996070	1080923
18090_2#185	11	0	11	0	977892	0.000000	0.000000	1998555	1091484
21242_2#136	186	138	48	3	872549	2.875000	0.062500	2035760	1223159
15608_4#48	4348	3100	1248	59	944173	2.483974	0.047276	1928464	1375507
21127_2#110	198	67	131	6	1102073	0.511450	0.045802	1937345	961222
19341_2#104	40	0	40	0	979737	0.000000	0.000000	1995549	1086032
18090_2#173	8	0	8	0	977753	0.000000	0.000000	1999959	1091187
15608_3#43	36	36	0	1	982244	0.000000	0.000000	2019487	1088383
13710_2#61	109	66	43	1	28263	1.534884	0.023256	1904972	1903015
18090_2#38	21	0	21	0	985474	0.000000	0.000000	2000263	1083378
15841_2#8	672	648	24	11	983451	27.000000	0.458333	2019238	1094176
22841_3#63	21	5	16	1	986860	0.312500	0.062500	2022062	1087268
15608_3#52	4	0	4	0	984885	0.000000	0.000000	2013172	1085465
13470_1#89	191	163	28	6	989576	5.821429	0.214286	2019744	1092256
11822_1#53	63	58	5	2	983647	11.600000	0.400000	2101428	1133426
15682_2#62	11	0	11	0	1145328	0.000000	0.000000	1990319	923052
15608_4#29	82	70	12	1	986764	5.833333	0.083333	2029377	1091505
11822_1#39	154	144	10	2	982646	14.400000	0.200000	2103147	1134305
15608_3#46	8	0	8	0	982218	0.000000	0.000000	2019482	1088105
15874_1#72	145	129	16	1	983322	8.062500	0.062500	2020337	1087131
13414_8#75	340	324	16	8	982238	20.250000	0.500000	2025570	1090031
15682_1#37	149	86	63	2	868877	1.365079	0.031746	1992200	1189754
19341_2#100	5	0	5	0	979731	0.000000	0.000000	1998658	1087599
21127_1#171	246	32	214	2	856015	0.149533	0.009346	2033773	1222643
18090_2#46	207	184	23	1	979676	8.000000	0.043478	2024078	1096966
18623_5#58	2	0	2	0	1129808	0.000000	0.000000	2004890	948249
14566_6#81	73	62	11	2	989698	5.636364	0.181818	2028596	1077923
15682_2#8	243	205	38	5	1140193	5.394737	0.131579	1999510	948260
11822_1#83	78	52	26	3	968456	2.000000	0.115385	2093868	1141681
14257_1#24	6	0	6	0	978731	0.000000	0.000000	2020169	1088447
13414_8#44	13	5	8	1	978731	0.625000	0.125000	2029481	1088762
14412_1#89	197	169	28	4	988112	6.035714	0.142857	2012780	1070206
14412_1#95	17	5	12	1	982810	0.416667	0.083333	2023963	1086572
19084_8#29	291	255	36	2	972959	7.083333	0.055556	1994511	1086962
15608_3#81	1	0	1	0	982104	0.000000	0.000000	2018988	1087326
13414_2#55	152	116	36	3	23724	3.222222	0.083333	1949000	1947043
14412_1#62	1169	1126	43	15	1052931	26.186047	0.348837	1982660	1072949
18090_2#44	20	5	15	1	977941	0.333333	0.066667	1999028	1090392
15608_2#61	6	0	6	0	984074	0.000000	0.000000	2093496	1132385
14566_5#24	1023	970	53	20	992775	18.301888	0.377358	1995332	1116173
15608_3#49	117	108	9	1	985908	12.000000	0.111111	2028690	1092795
10900_6#96	181	130	51	3	902137	2.549020	0.058824	2041355	1170503
15608_2#40	113	108	5	1	988856	21.600000	0.200000	2092965	1132522
13415_7#64	287	260	27	3	997223	9.629630	0.111111	2016276	1093387
11657_2#80	2	0	2	0	984074	0.000000	0.000000	2094483	1132758
14673_2#11	48	38	10	2	997518	3.800000	0.200000	2094246	1118792
17794_8#155	141	119	22	4	1128679	5.409091	0.181818	1986249	945059
13415_6#36	41	21	20	1	978731	1.050000	0.050000	2023874	1090504
11822_1#15	8	0	8	0	984074	0.000000	0.000000	2095483	1133325
13415_7#77	8	0	8	0	978731	0.000000	0.000000	2024538	1090725
19341_3#58	225	192	33	7	1137211	5.818182	0.212121	1991914	945989
15608_4#17	3	0	3	0	985058	0.000000	0.000000	2012839	1084108
13414_4#22	54	40	14	1	997945	2.857143	0.071429	2106708	1119734
12837_5#33	74	52	22	2	963774	2.363636	0.090909	2037126	1108888
21242_2#141	3013	2642	371	45	1092153	7.121294	0.121294	1934124	1206433
15608_4#26	3	0	3	0	982162	0.000000	0.000000	2021995	1089014
21127_2#153	1795	1670	125	32	1212805	13.360000	0.256000	1932188	1027632
19341_2#66	5	0	5	0	979728	0.000000	0.000000	1997684	1087168
13470_1#60	70	40	30	2	977600	1.333333	0.066667	2016284	1084366
13154_2#50	9	0	9	0	959733	0.000000	0.000000	1993445	1091880
18090_2#184	5	0	5	0	1129808	0.000000	0.000000	1990766	942542
11511_7#15	328	324	4	5	992215	81.000000	1.250000	2089289	1128373
15682_1#46	318	237	81	3	878101	2.925926	0.037037	1986784	1183874
19084_7#97	2253	1928	325	34	858459	5.932308	0.104615	1949156	1482203
15608_3#40	89	82	7	1	986341	11.714286	0.142857	2034502	1095743
15682_1#59	53	34	19	1	1128079	1.789474	0.052632	2003238	948088
11822_1#63	1	0	1	0	984074	0.000000	0.000000	2094692	1132963
19084_8#94	552	499	53	18	1033506	9.415094	0.339623	1956920	1068738
11822_1#13	7	0	7	0	983647	0.000000	0.000000	2078295	1130494
19341_2#87	6	0	6	0	979719	0.000000	0.000000	1997495	1086916
13415_4#2	751	720	31	9	992365	23.225807	0.290323	2004173	1091768
19341_2#67	0	0	0	0	1129808	0.000000	0.000000	1992114	943320
18090_2#39	2	0	2	0	1129808	0.000000	0.000000	1987037	942052
15608_5#86	33	0	33	0	979502	0.000000	0.000000	2005252	1089997
14257_1#30	70	19	51	2	977791	0.372549	0.039216	2016620	1085126
13415_8#3	21	0	21	0	989698	0.000000	0.000000	2024809	1079126
18090_2#158	13	0	13	0	977886	0.000000	0.000000	1998566	1090562
14555_3#6	76	55	21	2	982694	2.619048	0.095238	2031400	1086641
15608_2#31	2	0	2	0	983647	0.000000	0.000000	2075111	1129910
14566_5#36	1029	975	54	12	961704	18.055555	0.222222	2007987	1107896
12291_6#93	387	368	19	12	991481	19.368422	0.631579	2018329	1093927
14566_4#55	410	397	13	4	984608	30.538462	0.307692	2021376	1087602
13415_5#56	12	0	12	0	963774	0.000000	0.000000	2023120	1101456
19341_2#98	10	0	10	0	977878	0.000000	0.000000	2000195	1090628
15608_3#38	158	147	11	1	984917	13.363636	0.090909	2045310	1103040
18090_2#171	19	0	19	0	977852	0.000000	0.000000	1999415	1091384
15682_2#49	40	6	34	1	1145328	0.176471	0.029412	1991502	923470
15608_4#19	192	180	12	1	985005	15.000000	0.083333	2044619	1101178
13415_7#20	15	0	15	0	978731	0.000000	0.000000	2044880	1096998
N3	1190	831	359	29	595664	2.314763	0.080780	1963043	1605163
N9	862	817	45	18	1080276	18.155556	0.400000	1965011	1052366
N10	440	395	45	8	1028458	8.777778	0.177778	1977236	1063166
N8	254	228	26	5	1001333	8.769231	0.192308	2001270	1094599
N7	1379	1296	83	34	981332	15.614458	0.409639	2003238	1258428
N11	225	157	68	14	825113	2.308824	0.205882	2011294	1264304
N6	2520	2156	364	38	804357	5.923077	0.104396	2033359	1574731
N17	0	0	0	0	1126479	0.000000	0.000000	1997766	948858
N22	147	132	15	5	1152841	8.800000	0.333333	2027256	955344
N21	1	0	1	0	1126479	0.000000	0.000000	2030480	956490
N24	279	266	13	5	1145328	20.461538	0.384615	1995111	943694
N25	4	0	4	0	1126479	0.000000	0.000000	2007032	952914
N23	2	0	2	0	1126479	0.000000	0.000000	2011859	954334
N20	18	12	6	1	1126479	2.000000	0.166667	2038646	960133
N19	5	0	5	0	1126479	0.000000	0.000000	2039055	960300
N33	0	0	0	0	1129808	0.000000	0.000000	2006882	949111
N32	0	0	0	0	1129808	0.000000	0.000000	2008347	949568
N31	0	0	0	0	1129808	0.000000	0.000000	2009278	950027
N30	0	0	0	0	1129808	0.000000	0.000000	2009905	950269
N29	0	0	0	0	1129808	0.000000	0.000000	2010375	950441
N28	0	0	0	0	1129808	0.000000	0.000000	2010850	950706
N27	0	0	0	0	1129808	0.000000	0.000000	2011118	950858
N26	128	118	10	2	1129808	11.800000	0.200000	2011291	954033
N18	5	0	5	0	1126479	0.000000	0.000000	2044285	962693
N16	396	386	10	5	1126479	38.599998	0.500000	2044601	990055
N15	4135	3960	175	45	1099239	22.628571	0.257143	2045753	1275104
N36	194	135	59	5	855182	2.288136	0.084746	2040085	1237931
N47	52	40	12	1	977600	3.333333	0.083333	2022388	1088503
N46	136	135	1	5	976103	135.000000	5.000000	2025825	1102819
N45	17	13	4	2	963774	3.250000	0.500000	2033004	1107177
N52	18	15	3	1	963774	5.000000	0.333333	2025101	1102647
N53	181	178	3	3	968278	59.333332	1.000000	2026763	1102268
N51	12	6	6	1	963774	1.000000	0.166667	2030084	1104501
N50	35	29	6	2	963774	4.833333	0.333333	2030564	1104614
N54	134	118	16	4	967958	7.375000	0.250000	2022940	1100280
N49	0	0	0	0	963774	0.000000	0.000000	2032961	1105993
N48	0	0	0	0	963774	0.000000	0.000000	2047490	1114008
N44	12	0	12	0	963774	0.000000	0.000000	2051624	1117107
N43	7	7	0	1	963774	0.000000	0.000000	2053546	1120129
N56	227	214	13	3	980869	16.461538	0.230769	2025645	1100548
N63	25	6	19	1	972072	0.315789	0.052632	2025544	1094917
N62	3	0	3	0	971668	0.000000	0.000000	2027359	1095556
N64	2	0	2	0	971668	0.000000	0.000000	2024211	1094235
N61	0	0	0	0	971668	0.000000	0.000000	2029139	1096597
N60	10	7	3	1	971668	2.333333	0.333333	2029651	1096791
N59	2	0	2	0	971668	0.000000	0.000000	2031669	1098088
N67	417	412	5	4	988112	82.400002	0.800000	2015911	1082053
N66	43	34	9	3	976359	3.777778	0.333333	2029281	1097945
N65	96	88	8	2	971876	11.000000	0.250000	2033041	1100225
N58	91	90	1	2	971668	90.000000	2.000000	2037803	1102417
N57	15	15	0	1	971623	0.000000	0.000000	2038184	1108294
N55	41	37	4	2	965909	9.250000	0.500000	2038652	1112501
N42	1066	1029	37	19	961917	27.810810	0.513514	2058131	1144267
N41	85	78	7	4	941370	11.142858	0.571429	2062081	1148355
N76	3	0	3	0	978731	0.000000	0.000000	2046146	1096685
N75	48	39	9	1	978731	4.333333	0.111111	2048061	1097923
N74	3	0	3	0	978731	0.000000	0.000000	2050702	1099427
N81	1	0	1	0	978731	0.000000	0.000000	2023979	1090681
N80	1	0	1	0	978731	0.000000	0.000000	2026524	1092142
N79	4	0	4	0	978731	0.000000	0.000000	2049575	1100295
N94	0	0	0	0	982810	0.000000	0.000000	2032581	1087125
N93	0	0	0	0	982810	0.000000	0.000000	2034428	1088424
N92	60	57	3	1	982810	19.000000	0.333333	2035769	1089544
N95	44	39	5	2	989698	7.800000	0.400000	2033847	1087917
N91	0	0	0	0	982694	0.000000	0.000000	2038076	1090583
N90	0	0	0	0	982694	0.000000	0.000000	2038505	1090832
N96	78	72	6	1	982694	12.000000	0.166667	2026693	1088003
N89	0	0	0	0	982694	0.000000	0.000000	2039003	1091057
N88	64	63	1	3	982694	63.000000	3.000000	2039061	1091072
N87	0	0	0	0	982694	0.000000	0.000000	2039167	1091122
N86	0	0	0	0	982694	0.000000	0.000000	2039528	1091188
N85	0	0	0	0	982694	0.000000	0.000000	2040190	1091767
N84	55	55	0	2	982694	0.000000	0.000000	2041107	1096032
N83	6	6	0	1	978731	0.000000	0.000000	2056373	1103394
N98	0	0	0	0	978731	0.000000	0.000000	2022469	1089645
N97	200	188	12	1	978731	15.666667	0.083333	2048194	1099746
N82	14	11	3	1	978731	3.666667	0.333333	2060975	1106174
N78	0	0	0	0	978731	0.000000	0.000000	2061438	1106483
N100	2	0	2	0	978731	0.000000	0.000000	2021435	1089193
N99	26	5	21	1	978731	0.238095	0.047619	2023515	1090113
N77	0	0	0	0	978731	0.000000	0.000000	2061850	1106704
N73	4	0	4	0	978731	0.000000	0.000000	2062462	1106932
N72	27	25	2	2	978731	12.500000	1.000000	2065212	1108043
N71	15	12	3	1	978731	4.000000	0.333333	2065317	1108142
N70	1	0	1	0	978731	0.000000	0.000000	2065380	1108166
N69	0	0	0	0	978731	0.000000	0.000000	2065433	1108197
N68	1220	1173	47	16	978731	24.957447	0.340426	2065503	1147250
N40	0	0	0	0	939587	0.000000	0.000000	2073350	1153536
N39	571	505	66	18	939587	7.651515	0.272727	2074162	1189970
N38	500	480	20	6	901968	24.000000	0.300000	2076134	1247667
N105	627	619	8	6	998398	77.375000	0.750000	2092339	1117769
N113	0	0	0	0	984074	0.000000	0.000000	2095236	1133164
N112	13	10	3	1	984074	3.333333	0.333333	2095573	1133305
N111	1	0	1	0	984074	0.000000	0.000000	2101827	1133404
N110	0	0	0	0	984074	0.000000	0.000000	2101841	1133415
N109	0	0	0	0	984074	0.000000	0.000000	2103025	1134312
N108	0	0	0	0	984074	0.000000	0.000000	2103042	1134324
N107	113	111	2	2	984074	55.500000	1.000000	2103303	1136008
N117	8	0	8	0	982646	0.000000	0.000000	2116330	1135574
N120	1	0	1	0	982646	0.000000	0.000000	2114259	1134858
N129	0	0	0	0	983647	0.000000	0.000000	2097691	1132415
N128	20	10	10	1	983647	1.000000	0.100000	2101764	1134108
N134	144	129	15	1	983974	8.600000	0.066667	2102572	1133296
N135	3	0	3	0	983647	0.000000	0.000000	2109993	1134346
N133	20	19	1	2	983647	19.000000	2.000000	2112562	1135001
N136	100	96	4	5	997518	24.000000	1.250000	2107548	1134090
N132	9	6	3	1	983647	2.000000	0.333333	2113056	1135236
N131	6	0	6	0	983647	0.000000	0.000000	2113976	1135846
N130	11	6	5	1	983647	1.200000	0.200000	2114974	1135872
N127	6	0	6	0	983647	0.000000	0.000000	2115055	1135919
N126	0	0	0	0	983647	0.000000	0.000000	2115113	1135946
N125	0	0	0	0	983647	0.000000	0.000000	2115147	1135975
N124	43	41	2	2	983647	20.500000	1.000000	2115158	1136986
N123	78	78	0	2	982646	0.000000	0.000000	2115263	1137012
N138	0	0	0	0	984069	0.000000	0.000000	2075012	1129875
N137	61	52	9	1	984069	5.777778	0.111111	2089120	1133201
N122	6	0	6	0	982646	0.000000	0.000000	2115330	1137025
N121	13	9	4	1	982646	2.250000	0.250000	2115605	1137098
N119	1	0	1	0	982646	0.000000	0.000000	2118296	1137101
N118	0	0	0	0	982646	0.000000	0.000000	2118297	1137101
N116	3	0	3	0	982646	0.000000	0.000000	2118329	1137115
N115	1	0	1	0	982646	0.000000	0.000000	2118329	1137115
N114	0	0	0	0	982646	0.000000	0.000000	2120257	1138371
N106	378	370	8	4	982646	46.250000	0.500000	2120353	1140881
N104	455	432	23	8	980205	18.782608	0.347826	2120364	1160236
N143	0	0	0	0	967868	0.000000	0.000000	2099804	1144901
N142	4	0	4	0	967868	0.000000	0.000000	2110008	1149099
N141	75	72	3	2	967868	24.000000	0.666667	2110232	1152817
N140	2	0	2	0	964318	0.000000	0.000000	2110979	1152836
N139	55	46	9	4	964318	5.111111	0.444444	2111131	1156413
N103	796	773	23	11	960848	33.608696	0.478261	2120589	1169806
N102	1056	984	72	21	951430	13.666667	0.291667	2120591	1264854
N145	168	158	10	1	990031	15.800000	0.100000	2044614	1100105
N149	61	48	13	1	988626	3.692308	0.076923	2024398	1089538
N148	13	12	1	1	985908	12.000000	1.000000	2038245	1096132
N147	6	0	6	0	985908	0.000000	0.000000	2058773	1107367
N150	82	71	11	3	990085	6.454545	0.272727	2043840	1099240
N146	44	27	17	1	985908	1.588235	0.058824	2060283	1108184
N144	2018	1915	103	29	985908	18.592234	0.281553	2061277	1231790
N101	34	20	14	2	856138	1.428571	0.142857	2120735	1275097
N37	28	11	17	2	845978	0.647059	0.117647	2121145	1277566
N35	63	42	21	3	843807	2.000000	0.142857	2121326	1280265
N159	146	143	3	1	986124	47.666668	0.333333	2023705	1089544
N158	200	162	38	3	986181	4.263158	0.078947	2030148	1100068
N160	1	0	1	0	979608	0.000000	0.000000	2038184	1101511
N157	0	0	0	0	979895	0.000000	0.000000	2046236	1107628
N156	9	0	9	0	979897	0.000000	0.000000	2046764	1108126
N162	10	0	10	0	979825	0.000000	0.000000	2030352	1100205
N164	5	0	5	0	985527	0.000000	0.000000	2004845	1086184
N163	182	161	21	1	985654	7.666667	0.047619	2065840	1118342
N161	29	19	10	1	979963	1.900000	0.100000	2068108	1119408
N155	14	6	8	1	980003	0.750000	0.125000	2071182	1122983
N154	0	0	0	0	978144	0.000000	0.000000	2091255	1129572
N153	0	0	0	0	978144	0.000000	0.000000	2091308	1129623
N152	51	48	3	1	978144	16.000000	0.333333	2091326	1129635
N173	1	0	1	0	982217	0.000000	0.000000	2025263	1090861
N172	0	0	0	0	982297	0.000000	0.000000	2026505	1091494
N171	8	0	8	0	982303	0.000000	0.000000	2027759	1092221
N174	1	0	1	0	982247	0.000000	0.000000	2024215	1090643
N170	46	21	25	2	982347	0.840000	0.080000	2028843	1095569
N177	0	0	0	0	984935	0.000000	0.000000	2017185	1087850
N176	40	31	9	1	985099	3.444444	0.111111	2019151	1089028
N179	172	160	12	1	985010	13.333333	0.083333	2030538	1092411
N184	210	203	7	1	985286	29.000000	0.142857	2036594	1096784
N185	42	40	2	1	985358	20.000000	0.500000	2039072	1098191
N183	74	72	2	2	985368	36.000000	1.000000	2042565	1100614
N182	20	9	11	2	985134	0.818182	0.181818	2051488	1106456
N181	24	18	6	2	985050	3.000000	0.333333	2052301	1106886
N180	14	13	1	1	985050	13.000000	1.000000	2052490	1106952
N178	0	0	0	0	985101	0.000000	0.000000	2053130	1107231
N175	138	110	28	3	985143	3.928571	0.107143	2054514	1113428
N169	0	0	0	0	979702	0.000000	0.000000	2055864	1114215
N168	0	0	0	0	979704	0.000000	0.000000	2056102	1114414
N167	164	142	22	3	979704	6.454545	0.136364	2056457	1114592
N188	34	0	34	0	979461	0.000000	0.000000	2019931	1095939
N189	6	0	6	0	979464	0.000000	0.000000	2045232	1106893
N187	7	0	7	0	979501	0.000000	0.000000	2051933	1111413
N191	365	340	25	1	986947	13.600000	0.040000	2032945	1100312
N193	0	0	0	0	979834	0.000000	0.000000	2001089	1088902
N192	12	0	12	0	979868	0.000000	0.000000	2003382	1090099
N190	1	0	1	0	979889	0.000000	0.000000	2036282	1102628
N186	12	0	12	0	979914	0.000000	0.000000	2059628	1117145
N166	41	13	28	2	979920	0.464286	0.071429	2063381	1120666
N195	3	0	3	0	977962	0.000000	0.000000	2004264	1093809
N198	3	0	3	0	977979	0.000000	0.000000	2001649	1093165
N197	5	0	5	0	977984	0.000000	0.000000	2005497	1093942
N200	2	0	2	0	978042	0.000000	0.000000	2005283	1094251
N202	1	0	1	0	977984	0.000000	0.000000	2003710	1092890
N204	1	0	1	0	977880	0.000000	0.000000	2004102	1093611
N205	0	0	0	0	977901	0.000000	0.000000	2004222	1093572
N203	0	0	0	0	977974	0.000000	0.000000	2007684	1095598
N201	1	0	1	0	978012	0.000000	0.000000	2009679	1096602
N199	3	0	3	0	978063	0.000000	0.000000	2010818	1097289
N196	0	0	0	0	978067	0.000000	0.000000	2011498	1097735
N194	32	5	27	1	978068	0.185185	0.037037	2012044	1097938
N165	9	0	9	0	978074	0.000000	0.000000	2064517	1121617
N151	1744	1624	120	32	978144	13.533334	0.266667	2093111	1267105
N34	512	422	90	20	841279	4.688889	0.222222	2121593	1325540
N14	1239	1122	117	29	796228	9.589744	0.247863	2121788	1479193
N209	10	7	3	1	867382	2.333333	0.333333	1999044	1194426
N208	277	234	43	8	867382	5.441861	0.186047	2001030	1253759
N207	1166	1085	81	26	808382	13.395061	0.320988	2024244	1400256
N212	1187	1172	15	11	1043735	78.133331	0.733333	2012543	1110259
N215	294	270	24	9	983464	11.250000	0.375000	1991540	1092580
N214	44	40	4	2	957198	10.000000	0.500000	2028013	1108259
N218	7	5	2	1	959733	2.500000	0.500000	2023424	1100246
N219	11	0	11	0	959733	0.000000	0.000000	1998777	1095347
N217	1	0	1	0	959733	0.000000	0.000000	2026377	1102051
N220	0	0	0	0	959733	0.000000	0.000000	2007310	1096236
N216	87	76	11	4	959733	6.909091	0.363636	2030237	1105888
N213	109	93	16	4	956346	5.812500	0.250000	2044651	1126267
N211	726	653	73	18	944822	8.945206	0.246575	2048516	1187886
N210	2272	2056	216	42	885264	9.518518	0.194444	2058002	1421039
N206	119	89	30	8	656388	2.966667	0.266667	2090188	1461545
N13	1197	944	253	26	642691	3.731225	0.102767	2121921	1620132
N12	213	182	31	14	501789	5.870968	0.451613	2121984	1648781
N5	129	74	55	6	473206	1.345455	0.109091	2122137	1660955
N224	888	842	46	22	1102073	18.304348	0.478261	1961101	1010314
N225	1101	1082	19	25	1148604	56.947369	1.315789	1936142	998608
N223	315	274	41	15	1045956	6.682927	0.365854	1978766	1045391
N222	2159	1832	327	46	1020420	5.602447	0.140673	1983215	1244301
N221	3122	2644	478	50	811206	5.531381	0.104603	2006977	1563143
N4	506	391	115	18	461182	3.400000	0.156522	2122340	1736485
N2	5312	3513	1799	71	385836	1.952752	0.039466	2122559	2122559
N226	29	17	12	2	1955	1.416667	0.166667	1955300	1955300
N1	0	0	0	0	0	0.000000	0.000000	2122636	2122636
